domain	url_name
zhihu.com	知乎
douban.com	豆瓣
so.com	好搜
bilibili.com	哔哩哔哩弹幕视频网
dict.cn	海词词典
mafengwo.cn	蚂蜂窝
120ask.com	有问必答网
apple.com	苹果官方网站
xiami.com	虾米音乐网
xiachufang.com	下厨房
mama.cn	妈妈网
meishichina.com	美食天下
jia.com	齐家网
d1xz.net	第1星座
gushiwen.org	古诗文网
sf-express.com	顺丰快递官网
zhcw.com	中彩网
yaolan.com	摇篮网
5156edu.com	无忧无虑中学语文网
iciba.com	爱词霸
le.com	乐视网
jjwxc.net	晋江文学城
youdao.com	有道
zgjm.org	周公解梦
gamersky.com	游民星空
kugou.com	酷狗音乐
yxdown.com	游迅网
mbalib.com	MBA智库
1905.com	电影网
66law.cn	华律网
51sole.com	搜了网
xmeise.com	美色商城
zhibo8.cc	直播吧
3dmgame.com	3DMGAME
mi.com	小米网
mtime.com	Mtime时光网
ip138.com	IP地址查询
9ku.com	九酷音乐网
dmzj.com	动漫之家
huya.com	虎牙直播
haodf.com	好大夫在线
jb51.net	脚本之家
12306.cn	中国铁路客户服务中心
csdn.net	CSDN
redocn.com	红动中国
56.com	56网
quanjing.com	全景图片网
dianping.com	大众点评网
jiameng.com	全球加盟网
google.cn	谷歌中国
zongheng.com	纵横中文网
huawei.com	华为
9game.cn	九游手机网游
189.cn	中国电信网上营业厅
nba.com	NBA官方网站
jiayuan.com	世纪佳缘
pc6.com	PC6下载站
yinyuetai.com	音悦台
ruiwen.com	中学语文教学资源网
58pic.com	千图网
hjenglish.com	沪江英语
cnblogs.com	博客园
lianjia.com	链家网
mapbar.com	图吧
cnki.net	中国知网
vmall.com	华为商城
tiexue.net	铁血网
xilu.com	西陆网
aizhan.com	爱站网
che168.com	二手车之家
exam8.com	考试吧
wed114.cn	Wed114结婚网
haodou.com	好豆网
ximalaya.com	喜马拉雅FM
kaoyan.com	考研网
faloo.com	飞卢中文网
crsky.com	非凡软件站
vip.com	唯品会
cp2y.com	彩票2元网
zdic.net	汉典
meilele.com	美乐乐家具网
paopaoche.net	跑跑车游戏网
yw11.com	起名网
qiushibaike.com	糗事百科
baofeng.com	暴风影音官网
xxsy.net	潇湘书院
cr173.com	西西软件园
shangc.net	尚之潮网
moegirl.org	萌娘赛高基金会
china-10.com	中国十大品牌网
maigoo.com	买购网
5ykj.com	莲山课件
buyiju.com	卜易居 
microsoft.com	微软官网
nipic.com	昵图网
mofangge.com	魔方格
toutiao.com	今日头条
yanyue.cn	烟悦网
manmankan.com	漫漫看
dxsbb.com	大学生必备网
qulishi.com	 趣历史网
chachaba.com	查查吧
bytravel.cn	博雅旅游网
xiaopi.com	小皮游戏
mydrivers.com	驱动之家
liqucn.com	历趣
zdface.com	FACE妆点网
t086.com	IT学习网
zuowen.com	作文网
17500.cn	乐彩网
mnw.cn	闽南网
126.com	126网易免费邮
ooopic.com	我图网
81.cn	中国军网
chinaacc.com	中华会计网校
wbiao.cn	万表网
smzdm.com	什么值得买
1kkk.com	极速漫画
enterdesk.com	回车桌面
39yst.com	三九养生堂
aliyun.com	阿里云
u17.com	有妖气
amazon.cn	亚马逊中国官网
to8to.com	土巴兔装修网
ithome.com	IT之家
bing.com	微软必应搜索
findlaw.cn	找法网
dm5.com	动漫屋
miui.com	MIUI官方网站
aicai.com	爱彩网
17k.com	17k小说网
xici.net	西祠胡同
388g.com	随便吧
gucheng.com	股城网
tencent.com	腾讯
qyer.com	穷游网
114la.com	114啦
sto.cn	申通快递
taoche.com	淘车网
china.cn	中国供应商
07073.com	07073游戏网
faxingw.cn	发型屋
csair.com	中国南方航空
233.com	233网校
cyol.com	中青在线
gaokao.com	高考网
yoka.com	YOKA时尚网
hc360.com	慧聪网
10010.com	中国联通网上营业厅
huaban.com	花瓣网
zhe800.com	折800网
jstv.com	江苏网络电视台
elong.com	艺龙旅行网
kongfz.com	孔夫子旧书网
cri.cn	国际在线
cztv.com	新蓝网
36kr.com	36氪
fx678.com	汇通网
xiaogushi.com	小故事
guokr.com	果壳网
feng.com	威锋网
kuai8.com	快吧游戏
dajie.com	大街网
linkedin.com	领英
gongchang.com	世界工厂网
pchome.net	电脑之家
damai.cn	大麦网
win007.com	球探网
sanguosha.com	三国杀官方网站
abchina.com	中国农业银行官网
xinli001.com	壹心理
kekenet.com	可可英语
meitu.com	美图网
yingjiesheng.com	应届生求职网
360che.com	卡车之家
e23.cn	舜网
jiaoyimao.com	交易猫
onegreen.net	QQ资料库
hp.com	惠普官方网站
ecitic.com	中信金融网
365jia.cn	万家热线
6.cn	6间房
tangdou.com	糖豆网
unjs.com	中国大学网
xitek.com	色影无忌
chinabyte.com	比特网
1ting.com	一听音乐网
lvmama.com	驴妈妈旅游网
kdnet.net	凯迪网络
bankcomm.com	交通银行官网
windows7en.com	Win7之家
uc.cn	UC浏览器官方网站
cjdby.net	超级大本营
docin.com	豆丁文库
ly.com	同程网
babytree.com	宝宝树
wasu.cn	华数TV网
cnmo.com	手机中国
appchina.com	应用汇
dxy.cn	丁香园
25pp.com	PP助手
pps.tv	PPS网络电视官方网站
baihe.com	百合网
55125.cn	中国彩吧
3d66.com	3D溜溜网
33lc.com	绿茶软件园
tvsou.com	搜视网
jiemian.com	界面新闻
zhenai.com	珍爱网
sporttery.cn	中国竞彩网
manmanbuy.com	慢慢买
leju.com	乐居房产
91jm.com	就要加盟网
meizu.com	魅族官网
chaoxing.com	超星网
yhd.com	1号店
shejiben.com	设计本
wps.cn	WPS Office官方网站
pcpop.com	泡泡网
fun.tv	风行网
cidianwang.com	词典网
wenming.cn	中国文明网
chinagwy.org	国家公务员考试网
sinaapp.com	新浪云计算
artron.net	雅昌艺术网
jianshe99.com	建设工程教育网
oschina.net	开源中国 
66rpg.com	橙光游戏中心
soyoung.com	新氧
160.com	驱动人生
maoyan.com	猫眼电影
hunantv.com	芒果TV
deppon.com	德邦官方网站
kafan.cn	卡饭网
boqii.com	波奇网
skycn.com	天空下载
oppo.com	OPPO手机官网
tingroom.com	在线英语听力室
shenchuang.com	深圳之窗
cas.cn	中国科学院
b2b168.com	八方资源网
made-in-china.com	中国制造网
qfang.com	Q房网
chinakaoyan.com	中国考研网
med66.com	医学教育网
xs8.cn	言情小说吧
feiwan.net	飞丸动漫网
cheshi.com	网上车市
fantizi5.com	繁体字网
narutom.com	火影忍者中文网
newcger.com	新CG儿
wallstreetcn.com	华尔街见闻
guahao.com	挂号网
chashebao.com	社保查询网
fututa.com	浮屠塔
caixin.com	财新网
360kad.com	康爱多网上药店
zhanqi.tv	战旗TV
elecfans.com	电子发烧友
muzhiwan.com	拇指玩
aliexpress.com	AliExpress
kongzhong.com	空中网
anyv.net	微信公众帐号大全
weizhang8.cn	全国车辆违章查询网
joyme.com	着迷网
idol001.com	爱豆
chinahr.com	中华英才网
28.com	28商机网
zuche.com	神州租车
alimama.com	淘宝联盟
dongao.com	东奥会计在线 
wdzj.com	网贷之家
csg.cn	中国南方电网
eqxiu.com	易企秀
shuaijiao.com	摔角网
china95.net	元亨利贞网 
aies.cn	在线繁体字转换工具
12371.cn	共产党员网
99114.com	中国网库
jokeji.cn	笑话集
s.cn	名鞋库
rouding.com	肉丁网
liansuo.com	中国连锁网
wandoujia.com	豌豆荚
mozilla.org	火狐浏览器
ik123.com	DJ总站
lanrentuku.com	懒人图库
8264.com	户外资料网
ceair.com	中国东方航空
xpcha.com	迅查网
kaixin001.com	开心网
78dm.net	78动漫模型玩具 
co188.com	土木工程网
9you.com	久游网 
gao7.com	搞趣网
colg.cn	Colg沃特碧游戏门户
baobao88.com	宝宝吧
znds.com	智能电视网
i4.cn	爱思助手官网
dhgate.com	敦煌网
9duw.com	九度网
pedaily.cn	投资界
cfi.cn	中财网
cheaa.com	中国家电网
oeeee.com	奥一网
mumayi.net	木蚂蚁社区
pengfu.com	捧腹网
99.com	99.com数字娱乐门户
fengj.com	中国二手设备网
dzsc.com	维库电子市场网
kdslife.com	宽带山
310win.com	彩客网
pinggu.org	人大经济论坛
intel.com	英特尔
263.net	263邮箱
cebbank.com	中国光大银行官网
21cnjy.com	21世纪教育网
mipang.com	米胖网
jiankang.com	百姓健康网
a9vg.com	A9VG电玩部落
chinaxinge.com	中国信鸽信息网
unity3d.com	Unity3D
newsmth.net	水木社区
jzb.com	家长帮
topsage.com	大家网
2liang.net	爱靓网
quanmama.com	券妈妈优惠券网
55128.cn	彩吧助手
99sushe.com	99宿舍
msn.com	MSN中文网
gfan.com	机锋网
kanunu8.com	努努书坊
chinatimes.com	中时电子报
dv37.com	地纬商机网
buildhr.com	建筑英才网
xincheping.com	新车评网
fblife.com	越野e族
zgzcw.com	中国足彩网
sfacg.com	SF互动传媒网
sina.com	新浪
sciencenet.cn	科学网
xiaomi.cn	小米官网手机社区
cardbaobao.com	卡宝宝网
fanli.com	返利网
kankanews.com	看看新闻网
book118.com	e书联盟
howbuy.com	好买基金网
lawtime.cn	法律快车
gai001.com	第一改装网
bianzhirensheng.com	编织人生
msi.com	微星官网
vancl.com	凡客诚品
p5w.net	全景网
jumpw.com	《300英雄》官方网站
huochepiao.com	火车票网
ijinshan.com	金山网络
61ertong.com	六一儿童网
soso.com	搜搜
szhome.com	深圳房地产信息网
youboy.com	一呼百应
ccmn.cn	长江有色金属网
dhl.com	DHL
feijiu.net	中国废旧物资网
oray.com	花生壳官网
ycwb.com	金羊网
dd373.com	DD373游戏交易平台
xueersi.com	学而思网校
ch.com	春秋航空官方网站
shopbop.com	SHOPBOP
115.com	115网盘
aiyuke.com	爱羽客
yh31.com	永恒网
ssqzj.com	3D之家
myapp.com	应用宝
ibabyzone.cn	宝宝地带亲子网
e0575.com	绍兴e网
etao.com	一淘网
travelsky.com	信天游
jobcn.com	卓博人才网
candou.com	蚕豆网
78500.cn	彩宝贝
js-lottery.com	江苏体彩网
huibo.com	汇博人才网
11467.com	顺企商务网
52fuqing.com	爱福清网
fobshanghai.com	福步外贸网
tvb.com	tvb
zymk.cn	漫客网
hznzcn.com	杭州女装网
darryring.com	戴瑞珠宝官方网站
qianzhan.com	前瞻网
zaixian-fanyi.com	青云在线翻译网
315che.com	中国汽车消费网
daoxila.com	到喜啦
xiaopin5.com	小品屋
xinnet.com	新网
hrloo.com	三茅人力资源网
szhgh.com	红歌会网 
5253.com	5253手游网
cqmmgo.com	重庆购物狂
3454.com	3454小游戏
xiao84.com	巴士笑话网
597.com	597厦门人才网
sci99.com	卓创资讯 
zhan.com	小站教育
kukudm.com	kuku动漫 
badmintoncn.com	中羽在线网  
lmjx.net	中国路面机械网
110.com	110法律咨询网
southmoney.com	南方财富网
shangxueba.com	上学吧
yohobuy.com	YOHO有货
burberry.com	Burberry
zuzuche.com	租租车
smm.cn	上海有色网
readnovel.com	小说阅读网
smartisan.com	锤子科技官网
sm.cn	神马搜索
taisha.org	太傻网
yeah.net	yeah.net网易免费邮
tenpay.com	财付通
cityhouse.cn	城市房产
saraba1st.com	寻找卓明谷
job5156.com	智通人才网
xmfish.com	厦门小鱼网
cyzone.cn	创业邦
lizhi.fm	荔枝FM
immomo.com	陌陌
qdmm.com	起点女生网
htc.com	HTC 中国
mobanwang.com	模板王
popiano.org	流行钢琴网
yyfensi.com	YY粉丝网
tcl.com	TCL集团官网
anzhi.com	安智网
3533.com	3533手机世界
yaofangwang.com	药房网商城
zzidc.com	景安网络
uzzf.com	东坡下载
1518.com	1518姓名测试
juji123.com	剧集之家
bjeea.cn	北京教育考试院
chinacourt.org	中国法院网
cssmoban.com	css模板之家
biketo.com	自行车网
zhulang.com	逐浪网
globrand.com	全球品牌网
chengdu.cn	成都全搜索
ynzp.com	云南招聘网
xiziwang.net	西子美发网
amd.com	AMD
flyme.cn	魅族Flyme官网
coach.com	COACH蔻驰官网
jxpta.com	江西人事考试网
21ic.com	21IC中国电子网
admin5.com	站长网
poco.cn	POCO.CN
womai.com	我买网
nowscore.com	捷报比分网
e-chinalife.com	中国人寿官网
qiaobutang.com	乔布简历
azg168.cn	祥安阁风水网
youzan.com	有赞
cang.com	华夏收藏网
homekoo.com	新居网
4399.cn	4399手机游戏网
xiaohei.com	小黑游戏
3987.com	统一下载站
chimelong.com	长隆旅游 
yuemei.com	悦美整形网
chemcp.com	中国化工产品网
cehome.com	铁甲工程机械网
zgpingshu.com	中国评书网
360.com	360公司
dayoo.com	大洋网
tongbu.com	同步网络
53shop.com	53货源网
xmnn.cn	厦门网
goodjobs.cn	新安人才网
mumayi.com	木蚂蚁
ahgame.com	安游在线
bidchance.com	中国招标网
cpdyj.com	彩票大赢家
hdpfans.com	高清范HDPfans
11185.cn	中国邮政网上营业厅
gexing.com	个性网
veryeast.cn	最佳东方
chinaso.com	中国搜索
fx168.com	FX168外汇宝
stnn.cc	星岛环球网
umeng.com	友盟
k73.com	K73电玩之家
ppkao.com	考试资料网
biomart.cn	丁香通
cnsat.net	中文寻星
dili360.com	中国国家地理网
qqyou.com	Q友网
yinxiang.com	印象笔记
b2b.cn	必途网
flvcd.com	硕鼠官网
ikang.com	爱康国宾体检
civilcn.com	土木工程网
razerzone.com	雷蛇官网
hainan.net	海南在线
hualongxiang.com	化龙巷
ijntv.cn	济南网
gangqinpu.com	虫虫钢琴
zhijinwang.com	中国纸金网
foodmate.net	食品伙伴网
wanyx.com	玩游戏网
netbig.com	网大
youbian.com	邮编查询网
lusongsong.com	卢松松博客
95516.com	银联钱包
jobbole.com	伯乐在线
91160.com	就医160挂号网
yuanlin.com	中国园林网
5i5j.com	我爱我家网
cssn.cn	中国社会科学网
eywedu.net	数学备课大师
cnool.net	东方热线
pipaw.com	琵琶网
job1001.com	一览英才网
jqw.com	金泉网
weidian.com	微店
pcbeta.com	远景在线
centanet.com	中原地产
cnwest.com	西部网
1hai.cn	一嗨租车
61baobao.com	61宝宝网
gdtv.cn	广东广播电视台
excelhome.net	Excel Home
kq36.com	康强医疗人才网
bozhong.com	播种网
3366.com	3366小游戏
ihg.com	IHG
xiamenair.com	厦门航空官网
7399.com	7399小游戏
newyx.net	牛游戏网
accaglobal.com	ACCA Global
xizi.com	西子湖畔
bootcss.com	Bootstrap中文网
gyyx.cn	光宇游戏
114piaowu.com	114票务网
carnoc.com	民航资源网 
gpsuu.com	GPS之家
examw.com	中华考试网
yupoo.com	又拍网
anhuinews.com	中安在线
qcloud.com	腾讯云
cqvip.com	维普网
tuchong.com	图虫网
wanda.cn	万达官网
tom.com	TOM
vanke.com	万科集团
zqgame.com	中青宝
yaodaojiao.com	妖道角
zjstv.com	浙江卫视官方网站
wmzhe.com	完美天空
5tu.cn	百图汇
qihoo.com	奇虎网
yxzoo.com	游戏园
7881.com	7881游戏交易平台
cnstock.com	中国证券网
henan100.com	河南一百度
ingping.com	音平商城
liba.com	篱笆网
douxie.com	斗蟹游戏网
edu24ol.com	环球网校
faw-vw.com	一汽大众
cltt.org	全国普通话培训测试信息资源网
redhat.com	红帽公司官网
anjian.com	按键精灵
zhuoku.com	桌酷壁纸
sinopec.com	中国石化
hljtv.com	黑龙江网络广播电视台
dahe.cn	大河网
speiyou.com	学而思培优
sdcp.cn	山东彩票
paidai.com	派代网
beatsbydre.com	Beats by Dre 中文官方网站
xixik.com	嘻嘻网
uu898.com	悠悠游戏服务网
800bestex.com	百世汇通
delta.com	达美航空公司
sjwyx.com	手游之家
kumi.cn	酷米网
snh48.com	SNH48中国官方网站
114huoche.com	114火车网
hxrc.com	中国海峡人才网
huabian.com	花边星闻
eywedu.com	语文资源网
ydss.cn	移动叔叔
hmlan.com	中国兰花交易网
cs090.com	常熟零距离
zhiyoo.com	智友
chuansong.me	传送门
wmxa.cn	西安文明网
mingxing.com	明星网
taoshouyou.com	淘手游
gxsky.com	时空网
0594.com	莆房网
k366.com	K366华易网
duba.com	毒霸网址大全 
dgtle.com	数字尾巴
hku.hk	香港大学
yingyu.com	英语网
jiaodong.net	胶东在线
zwcad.com	中望cad
migu.cn	咪咕音乐
sc115.com	素彩网
sinosig.com	阳光保险
zwcad.com	中望cad
hxrc.com	中国海峡人才网
behance.net	Behance
yxzoo.com	游戏园
hku.hk	香港大学
cnforex.com	环球外汇
genshuixue.com	跟谁学
kumi.cn	酷米网
jiancai365.cn	中国建材采购网
zxcs8.com	知轩藏书
newyx.net	牛游戏网
7723.cn	7723手机游戏
xiaohongshu.com	小红书
chuansong.me	传送门
yinyuezj.com	音乐之家
7788.com	7788商城
biligame.com	哔哩哔哩游戏中心
ef360.com	华衣网
cnal.com	中铝网 
ydniu.com	一定牛
zjtcn.com	造价通
autonavi.com	高德
xiaohongshu.com	小红书
banggo.com	邦购网
xhby.net	新华报业网
appgame.com	任玩堂
tujia.com	途家网
goumin.com	狗民网
virscan.org	VirSCAN.org
game2.cn	哥们网页游戏平台
chasedream.com	ChaseDream
yinyuezj.com	音乐之家
zikao365.com	自考365 
17mcp.com	众彩网
haozu.com	好租
gewara.com	格瓦拉生活网
mydigit.cn	数码之家
genshuixue.com	跟谁学
chinadance.cn	中国舞蹈网
knowsky.com	动态网站制作指南
ybjk.com	元贝驾考
yesmywine.com	也买酒
gzmama.com	广州妈妈网
moonbasa.com	梦芭莎
zxcs8.com	知轩藏书
spbo1.com	体球网
16fan.com	十六番
vobao.com	沃保保险网
wo99.net	wo99免费伴奏翻唱
glodon.com	广联达软件股份有限公司
51daifu.com	医生在线 
ipanda.com	熊猫频道
putclub.com	普特英语听力
91huayi.com	华医网
12999.com	12999数学站
55.la	我拉网
masok.cn	马鞍山OK论坛
91job.com	恒信人才网
68design.net	网页设计师联盟
kuaiyong.com	快用苹果助手
10yan.com	十堰秦楚网
jc001.cn	九正建材网
yxlady.com	伊秀女性网
dospy.com	Dospy智能手机网
jc258.cn	258竞彩网
9377.com	9377网页游戏
laohu.com	老虎游戏
hengyan.com	恒言中文网
cnforex.com	环球外汇
taiwan123.cn	台湾之窗 
my0511.com	镇江网友之家
eshow365.com	E展网
tiboo.cn	地宝网
mitsubishielectric.com	三菱电机官方网站
tzrl.com	台州人力网
xhd.cn	新航道
beva.com	贝瓦网
zocai.com	佐卡伊官网
guitarchina.com	吉他中国
faw-mazda.com	一汽马自达汽车销售有限公司
neotv.cn	牛视网
zjzs.net	浙江教育考试院
hx2car.com	华夏二手车
iresearch.cn	艾瑞网
govyi.com	公文易文秘资源网
shikee.com	试客联盟
sonhoo.com	商虎中国
tgfcer.com	TGFC
gter.net	寄托天下
huihui.cn	惠惠网
ludashi.com	鲁大师
earthol.com	地球在线
67.com	中国娱乐网
layui.com	layui官网
qiaohu.com	巧虎官方网站
xinjunshi.com	新军事网
itools.cn	iTools苹果官网
293.net	293.net
sdbys.cn	山东高校毕业生就业信息网
cits.cn	国旅在线
wto168.net	国际珠宝网
glzy8.com	管理资源吧
eyuyao.com	余姚生活网
hunliji.com	婚礼纪
miss-no1.com	第一女人网
gaosiedu.com	高思教育
01ny.cn	南阳网
itheima.com	黑马程序员官网
sodao.com	搜道网
0731fdc.com	0731房产网
yaowan.com	要玩网页游戏平台
strawberrynet.com	香港草莓网
yintai.com	银泰网
hebtv.com	河北网络电视台
shdjt.com	散户大家庭
21cp.com	中塑在线
9666.cn	牛仔网
fangtoo.com	房途房产网
q1.com	冰川网络
shilladfs.com	新罗免税店
bandao.cn	半岛网
indeed.com	indeed求职网
4k123.com	4K中国
7788.com	7788商城
bioon.com	生物谷
longhoo.net	龙虎网
donews.com	DoNews
xiaoji001.com	小鸡模拟器 
fangte.com	方特网
bzfxw.com	标准分享网
jfdaily.com	解放牛网
zhuna.cn	住哪网
ahtv.cn	安徽网络电视台
geihui.com	给惠网
liebao.cn	猎豹安全浏览器
fhyx.com	凤凰游戏商城
cofool.com	叩富网
xiaozhu.com	小猪短租网
jszks.cn	驾驶证考试网
d.cn	当乐网
55bbs.com	我爱购物网
ledu.com	乐都网
eebbk.com	步步高教育电子官网
cyberpolice.cn	网络违法犯罪举报网站
runsky.com	大连天健网
yougou.com	优购网
eelly.com	衣联网
tuitui99.com	推推99房产网
kuakao.com	跨考考研网
xunjiepdf.com	迅捷pdf转换成word转换器
neusoft.com	东软
5184.com	广东考试服务网
moxiu.com	魔秀
oh100.com	百分网
e21.cn	湖北教育信息网
junzhuan.com	军转网
thn21.com	华语网
chebiaow.com	车标网
actoys.net	AC模玩网
jy510.com	江阴房产网
11773.com	11773手游网
winning11cn.com	完全实况11论坛
zjut.cc	千栀网
fawan.com	法制晚报 
cmcm.com	猎豹移动公司
eeyy.com	一游网
kingroot.net	Kingroot官网
webmasterhome.cn	中国站长之家
smartstudy.com	智课网
shgao.com	商告网
sooopu.com	搜谱网
iyaxin.com	亚心网
zhonghuasuan.com	众划算
shenzhenair.com	深圳航空
tmjob88.com	土木英才网
thea.cn	教育联展网
yiqibazi.com	易奇八字
zou114.com	走114查询网
114huoche.com	114火车网
chebiaow.com	车标网
hunliji.com	婚礼纪
downhot.com	管理资料下载
cnedu.cn	考研教育网
jc258.cn	258竞彩网
shgao.com	商告网
7881.com	7881游戏交易平台
lightnovel.cn	轻之国度
bzfxw.com	标准分享网
zhonghuasuan.com	众划算
4k123.com	4K中国
wodeshucheng.com	我的书城网_
taofen8.com	淘粉吧
oicq88.com	QQ网名
myherocn.com	我的英雄学院中文网
kingroot.net	Kingroot官网
shenzhenair.com	深圳航空
zou114.com	走114查询网
ankangwang.com	安康网 
0579.cn	浙中在线
ecar168.cn	购车网
ehaier.com	海尔商城
qiuyi.cn	求医网
119g.com	119G免费网盘
hercity.com	倾城网
shuhai.com	书海小说网
123cha.com	123CHA
snail.com	蜗牛官网
tuwan.com	兔玩网
cntaiping.com	中国太平保险集团官方网站
youshang.com	金蝶友商网
dooland.com	读览天下
8080.net	极速网
longtugame.com	龙图游戏
gxeea.cn	广西招生考试院
hisense.com	海信官网
qc188.com	汽车江湖网
hefei.cc	合肥热线
hnagroup.com	海航集团官方网站
xy.com	xy游戏
jieju.cn	中洁网
xueda.com	学大教育官网
quanlaoda.com	券老大
i21st.cn	21英语
chazidian.com	查字典
china-pub.com	china-pub网上书店
cfw.cn	中国服装人才网
ph66.com	平湖在线
cnzol.com	中网在线
tobosu.com	土拨鼠装修网
zupulu.com	族谱录
vpgame.com	VPGame
ray-ban.com	雷朋眼镜
dedecms.com	织梦CMS官方网站
eeafj.cn	福建省教育考试院
gtja.com	国泰君安证券
7po.com	奇珀网
jianzhi8.com	兼职吧
4px.com	递四方速递
iweihai.cn	爱威海网
060s.com	小精灵儿童网站
tnbz.com	糖尿病网
kaoshidian.com	考试点
gzevergrandefc.com	广州恒大淘宝足球俱乐部
lcread.com	连城读书
chahaoba.com	查号吧
beibei.com	贝贝网
classic023.com	经典重庆网
shcaoan.com	中华娱乐网
ahzsks.cn	安徽省教育招生考试院
sun0769.com	东莞阳光网
taiwan.cn	中国台湾网
40407.com	40407游戏网
0513.org	濠滨网
15tianqi.cn	 15天气网
jyb.cn	中国教育新闻网
job001.cn	国际人才网
youyuan.com	有缘网
leiting.com	雷霆游戏官方网站
haedu.cn	河南省教育网
kimiss.com	闺蜜网
facang.com	发藏网
hxsd.com	火星网
fabao365.com	法邦网
sssc.cn	盛世收藏网
jysq.net	暨阳社区（暨阳网）
1kejian.com	第一课件网
taofen8.com	淘粉吧
zcwz.com	中华轴承网
feeyo.com	飞友网
dyhjw.com	第一黄金网 
0573ren.com	嘉兴人论坛
cthy.com	中国旅游信息网
gionee.com	金立手机官网
0757rc.com	大佛山人才网
bwlc.net	北京福彩网
d1cm.com	第一工程机械网
szonline.net	深圳热线
inspur.com	浪潮
tumanduo.com	装修图满多
haiwainet.cn	海外网
gold600.com	价格行情网-
world68.com	世界各国网址大全
winbaicai.com	大白菜官网
fuling.com	涪陵在线
tigtag.com	滴答网
gongkong.com	中国工控网
kaiwind.com	凯风网
thmz.com	太湖明珠
hundsun.com	恒生电子
bdqn.cn	北大青鸟官方网站
cnedu.cn	考研教育网
xiangrikui.com	向日葵保险网
52cp.cn	双彩网
xna8.com	兴宁A8
eduyun.cn	国家教育资源公共服务平台
guqu.net	中国古曲网
sj998.com	商届招商网
macx.cn	苹果网
e3ol.com	三国在线
cutv.com	城市联合网络电视台
chcoin.com	古泉园地
liqu.com	利趣返利网
jcrb.com	正义网
680.com	时间财富网
szsh.com	深圳三和人才网
suning.cn	苏宁
ikanchai.com	砍柴网
pazx888.com	平安在线
gigabyte.cn	技嘉科技
aisino.com	航天信息股份有限公司
fenbi.com	粉笔网
ys168.com	永硕E盘
gamehome.tv	电视游戏第一站
bgm.tv	Bangumi 番组计划
xvna.com	炫浪网
mbachina.com	MBA中国网
chexun.com	车讯网
ebay.cn	eBay中国官网
zaih.com	在行
7192.com	全影网
212300.com	丹阳翼网
gdmm.com	茂名在线
eduease.com	易教网
nongmintv.com	农民网
myherocn.com	我的英雄学院中文网
zhiji.com	知己交友中心
2500sz.com	名城苏州
lvye.cn	绿野户外
thinkphp.cn	THINKPHP
yunnan.cn	云南网
zwbk.org	中文百科
shangpin.com	尚品网
baifubao.com	百付宝
poppur.com	爱换网
55you.com	55YOU魔兽地图站
haosou.com	360搜索
shijue.me	视觉me
meilishuo.com	美丽说
jinrongren.net	中公金融人网
huluxia.com	葫芦侠修改器官网
news18a.com	网通社
app111.com	苹果园
lcxw.cn	聊城新闻网
fengone.com	凤网
zhaoshangbao.com	招商宝
stylenanda.com	STYLENANDA 中文官网
5iyq.com	乐清上班族
simuwang.com	私募排排网
gog.cn	多彩贵州网 
leshan.cn	乐山新闻网
dn1234.com	1234网址大全
zp365.com	住朋网
eduu.com	e度教育网
92wy.com	万宇在线
gz0668.com	高州阳光网
alltobid.com	上海国际商品拍卖有限公司劲标网
qgyyzs.net	环球医药招商网
tuan800.com	团800
atpworldtour.com	ATP世界巡回赛官网
krdrama.com	韩剧社区
7to.cn	奇兔刷机官网
9wee.com	九维网
jseea.cn	江苏省教育考试院
xiumi.us	秀米 
jurong.cn	山水句容社区
chinairn.com	中国行业研究网
qqddc.com	全球电动车网
coocaa.com	酷开官网
bbicn.com	兵人在线
wenweipo.com	香港文汇网
703804.com	柒零叁
loveq.cn	一些事一些情
skykiwi.com	新西兰天维网
0735.com	郴州新网
zhuaniao.com	抓鸟英语
cnhan.com	汉网
sctv.com	四川广播电视台
mucfc.com	招联消费金融
mlbuy.com	米兰时尚服装批发网
xbus.cn	西安公交网
bbboo.com	包卜
guilinlife.com	桂林生活网
xtol.cn	湘潭在线新闻网
yaozh.com	药智网
vvjob.com	桂林人才网
meizu.cn	魅族官网
yooli.com	有利网
91cy.cn	91创业网
coloros.com	ColorOS官方网站
6xiu.com	联科绣花网
yp900.com	快易捷药品交易网
nphoto.net	新摄影
luosi.com	华人螺丝网
yeyou.com	页游网
cailele.com	彩乐乐彩票网
iteye.com	ITeye  
hjzlg.com	韩剧资料馆
job910.com	万行教师人才网
xxt.cn	校讯通
tesco.com	乐购超市官网
shhbm.com	上海打折网
cnnb.com	阿拉宁波网
enshi.cn	恩施新闻网
taian.com	泰安网
hlgnet.com	回龙观社区网
64gua.com	周易天地 
wenwuchina.com	中国文物网
uker.net	中英网
17game.com	一起玩网络
shulink.com	书连读书网
liverpoolfc.com	利物浦FC
qqbaobao.com	亲宝网
laifeng.com	来疯直播
happyvalley.cn	欢乐谷连锁主题公园
bato.cn	八通网
china-b.com	育龙网
wudao.com	中舞网 
zyctd.com	中药材天地网
chinapmp.cn	项目管理网
junshijidi.com	军事基地
byfen.com	百分网
xinglai.com	 星籁
ts.cn	天山网
heiguang.com	黑光网
ifensi.com	粉丝网
loveshang.com	张家港爱上网
uname.cn	逸名网
eetop.cn	中国电子顶级开发网
timedg.com	东莞时间网
scedu.net	四川教育网
ratoo.net	热图网
hbu.cn	河北大学
gk99.com	游戏港口
icesmall.cn	冰小百科
piaoliang.com	漂亮女人
zw3e.com	植物之家
114chn.com	中国114黄页
vipshop.com	唯品会
jyacht.com	精艇游艇网
ruyig.com	如意购
enjoyz.com	ENJOYZ足球装备网
ynrcc.com	云南省农村信用社
qumei.com	曲美家居
wuhunews.cn	芜湖新闻网
ntce.com	国家教师资格考试网
easiu.com	中国易修网
chinaiiss.com	中国战略网
egou.com	易购网
chinaunix.net	Unix技术网
toocle.com	生意宝
schneider-electric.cn	施耐德电气中国
jianglishi.cn	讲历史
hjwzw.com	黄金屋中文
macaodaily.com	澳门日报
51wan.com	我要玩
ct10000.com	中国电信网上营业厅
jdwx.cn	家电维修
ntce.com	国家教师资格考试网
photofans.cn	佳友在线摄影网
soueast-motor.com	东南汽车官网
macaodaily.com	澳门日报
ruyig.com	如意购
langfly.com	能飞英语网
jianglishi.cn	讲历史
enshi.cn	恩施新闻网
wenwuchina.com	中国文物网
chinapmp.cn	项目管理网
bianju.me	中国编剧网
yunfan.com	云帆搜索
xinglai.com	 星籁
99wed.com	久久结婚网
xiumi.us	秀米 
vipshop.com	唯品会
hundsun.com	恒生电子
58food.com	58食品网
ynrcc.com	云南省农村信用社
hjzlg.com	韩剧资料馆
v1.cn	第一视频
jctrans.com	锦程物流网
wanxue.cn	万学教育集团官方网站
qinzhou360.com	钦州360网
0516k.com	新沂城市论坛
in-en.com	国际能源网
99wed.com	久久结婚网
ijjnews.com	晋江新闻网
zhoushan.cn	舟山网
gzzk.cn	广州招考网 
mtuo.com	中国摩托车网
xiu.com	走秀网
cbg.cn	视界网
tropica.cn	CTA南美水族
959.cn	959品牌招商网
pediy.com	看雪软件安全网站
oppomobile.com	OPPO互联中心官方网站
99read.com	99网上书城
hb163.cn	淮北人论坛
xmhouse.com	厦门房地产联合网
51live.com	51LIVE
mf08s.com	中国美业网
wodeshucheng.com	我的书城网_
15hr.com	一网人才
py168.com	番禺社区
xwh.cn	新文化网
soueast-motor.com	东南汽车官网
dazhoushan.com	大舟山
0550.com	E滁网
youabc.cn	在途旅行网
beingmate.com	贝因美官网
itcast.cn	传智播客
96tui.cn	96推微商网
baobei360.com	中国婴童网
91danji.com	91单机游戏网
005.tv	羁绊网
5imx.com	5IMX
jjoobb.cn	九博人才网
railcn.net	中国铁道网
x-kicks.com	新新球鞋网
uzai.com	悠哉旅游网
v1.cn	第一视频
96369.net	西本新干线
12580.com	12580和生活
hxyjw.com	华夏医界网
360guakao.net	360挂靠网
198game.com	198game爱上玩家
qudong.com	驱动中国
yunos.com	YunOS
tv.cn	数字电视网
cstnet.cn	科技网
last.fm	Last.fm 
tongzhuo100.com	同桌100学习网
china50plus.com	人过50网
jiancai365.cn	中国建材采购网
273.cn	273中国二手车交易网
517best.com	旅游百事通在线商城
aibo123.com	爱波网
514200.com	大埔网
youtx.com	游天下
aoshitang.com	傲世堂
99ys.com	99艺术网
tongyi.com	中国统一教育网
70yx.com	麒麟游戏
sofang.com	搜房网
jsyst.cn	驾驶员试题网
plu.cn	PLU游戏娱乐传媒
ld0766.com	罗定E天空
chinacdc.cn	中国疾病预防控制中心
guiguanrc.com	桂冠人才网
jidujiao.com	基督教中文网
0634.com	莱芜都市网
lenovo.com	联想中国
bianju.me	中国编剧网
vc52.cn	精睿软件园
sanwen.net	散文网
zyue.com	众悦网
photofans.cn	佳友在线摄影网
hktdc.com	香港贸发局
jdbbx.com	简单百宝箱
m4.cn	四月网
wxrb.com	无锡新传媒
fjnet.com	佛教在线
zz91.com	ZZ91再生网
fanhuan.com	返还网
steelseries.com	赛睿官网
ename.cn	易名中国
ciming.com	慈铭体检
gameres.com	GameRes游资网
zy.com	卓越教育网
zol.com	中关村商城
lelezone.com	乐乐地带
yninfo.com	云南信息港
macd.cn	MACD门户
tompda.com	TomPda智能手机网
btcchina.com	比特币中国
coolpad.com	酷派商城
e763.com	小虫网
chinaren.com	ChinaRen校友录
2345daohang.com	2345导航
2cto.com	红黑联盟
tiens.com	天狮集团官方网站
mplife.com	名品导购网
nantaihu.com	南太湖网
teclast.com	台电科技
vipyl.com	雨露文章网
stcn.com	证券时报网
baobeihuijia.com	宝贝回家寻子网
cnaidc.com	中国自动识别网
5588.tv	火爆化妆品招商网
anxin.com	安心贷
duomi.com	多米音乐网
gongzhou.com	龚州网
xcabc.com	西游车展网
anywlan.com	中国无线门户
ruanmei.com	软媒 
emoney.cn	益盟操盘手
gdrc.com	广东人才网
feidee.com	随手记
hdjr.org	 黄道吉日网
wacai.com	挖财
jdjob88.com	一览机电英才网
hepu123.com	合浦123
hiwifi.com	极路由官网
luohuedu.net	罗湖教育信息网
tangjiu.com	中国糖酒网
sjzyxh.com	世界华人周易协会
boai.com	深圳博爱医院
bigear.cn	大耳朵英语
chinalao.com	职多多
nrsfh.com	女人私房话
seowhy.com	SEOWHY
wehefei.com	合肥网
cnfish.com	观赏鱼之家 
78.cn	创业商机网
steelcn.cn	中钢网
hongxiu.com	红袖添香
91wan.com	91wan网页游戏平台
kitstown.com	球衫堂
yangche51.com	养车无忧网
ikuai8.com	爱快
scezju.com	浙大继续教育学院
cnscg.com	圣城家园
cnyw.net	义乌热线
zxdyw.com	装一网
qz828.com	衢州新闻网
yododo.com	游多多旅行网
openrice.com	香港餐厅指南
jluzh.com	吉林大学珠海学院
enetedu.com	教育部全国高校教师网络培训中心
lefeng.com	乐蜂网
m3guo.com	梦三国官方网站
darongcheng.com	荣成信息港
tek.com	美国泰克Tek公司
syuan.net	声远网
yantuchina.com	中国岩土网
inlishui.com	丽水信息港
9158.com	9158聚乐网
5khouse.com	昆山二手房产网
shipxy.com	船讯网
52pcgame.net	52PCGame论坛
nihaowang.com	你好网
xuefa.com	学法网
yimanwu.com	一满屋
qu114.com	去114分类信息网
wemvp.com	实况MVP足球游戏网
jdyou.com	简单游
junshishu.com	铁血读书
zkteco.com	中控科技官方网站
meyet.com	美言网
xuzhoujob.com	徐州英才网
nec.com	NEC官方网站
0411hd.com	大连海岛旅游网
stonebuy.com	中国石材网
taojindi.com	淘金地
hwxnet.com	汉文学网
campusfrance.org	法国教育服务中心
52miji.com	我爱秘籍
icxo.com	世界经理人
canton8.com	蓝调粤语
51testing.com	软件测试网
yugaopian.com	预告片世界
mobage.cn	梦宝谷
ziling.com	子陵
job0663.com	揭阳招聘网
9998.tv	中国好酒招商网
kuyun.com	酷云互动
52hxw.com	火星文官网
gbs.cn	光波网
yugaopian.com	预告片世界
changshifang.com	常识坊
moyoyo.com	魔游游手游交易平台
lyy99.com	原野映像环球旅拍
cntaiping.com	中国太平保险集团官方网站
juren.com	巨人学校官方网站
bizcn.com	商务中国
wemvp.com	实况MVP足球游戏网
zhiyeapp.com	知页
hxyjw.com	华夏医界网
easeeyes.com	易视网
job0663.com	揭阳招聘网
luosi.com	华人螺丝网
l99.com	立方网
yimanwu.com	一满屋
canton8.com	蓝调粤语
xiadele.com	下得乐模型库
jctrans.com	锦程物流网
bajie1.com	八戒日付网
lilywed.cn	百合婚礼社区
tiaohao.com	挑号网
xyzs.com	XY苹果助手官网
c114.net	C114中国通信网
xijucn.com	戏剧网
zg163.net	自贡在线
bajiu.cn	八九网
l99.com	立方网
hznews.com	惠州新闻网
godsignal.com	黄金投资策略网
easeeyes.com	易视网
langfly.com	能飞英语网
yeeyan.org	译言网
houdao.com	猴岛
hh010.com	鸿鹄网
shouyou.com	手游网
gedu.org	环球雅思集团官方网站
kaitao.cn	开淘网
pp.cc	皮皮精灵
ls114.cn	溧水114网
love616.com	时尚魔女
bajie1.com	八戒日付网
jhrx.cn	江汉热线
hcwang.cn	河池网
chowsangsang.com	周生生
luanren.com	六安人论坛
northnews.cn	正北方网
bet007.com	奥迅球探网
souyi.cc	搜易分类信息
comsenz.com	北京康盛新创科技有限责任公司
xingzuo123.com	星座123
chinaceot.com	总裁网
sina.net	新浪企业邮箱
st001.com	汕头e京网
linekong.com	蓝港在线
asiatvro.com	亚洲卫星电视中文网
desktx.com	桌面天下
voicecloud.cn	语音云
bizcn.com	商务中国
koofang.com	酷房网
laomaotao.net	老毛桃
goepe.com	中国环保设备网
youxiake.com	游侠客旅游网
zhiyeapp.com	知页
cnair.com	中国航空旅游网
moyoyo.com	魔游游手游交易平台
7723.cn	7723手机游戏
lightnovel.cn	轻之国度
brtn.cn	BRTN北京网络台
9928.tv	中国美酒招商网
okhqb.com	华强北商城
lznews.cn	鲁中网
sdticai.com	山东体彩网
ckd.cc	查快递
365jilin.com	吉和网
zhiyin.cn	知音网
nongji360.com	农机360网
a963.com	中华室内设计网
tv189.com	天翼视讯
izhufu.net	主妇网
feiku.com	飞库网
wfbrood.com	万丰星际网
ddmap.com	丁丁网
musicool.cn	炫音音乐论坛
tgnet.com	天工网
chacuo.net	查错网
lexun.cn	乐讯手机高手
szxuexiao.com	深圳学校网
jxntv.cn	江西网络广播电视台
langya.cn	琅琊新闻网 
1yyg.com	1元云购
66game.cn	66街机游戏下载中心
ca800.com	中国自动化网
jinkaoedu.com	金考网
hnedu.cn	湖南教育网
qzwb.com	泉州网
maidi.me	吉安麦地网
zgfj.cn	中国佛教网
yunfan.com	云帆搜索
uu.cc	游娱社区
noahedu.com	诺亚舟教育网
ahrcu.com	安徽省农村信用社联合社
behance.net	Behance
cic.cn	中华保险
gamfe.com	汇众教育
hbglky.com	湖北公路客运（集团）有限公司
freep.cn	随意贴
wangjing.cn	望京网
shandian.biz	闪电站博客
rmfans.cn	皇马球迷俱乐部
uc108.com	同城游官网
jiajiaoban.com	智康1对1官网
bushi123.com	Bushi123网址之家
zxip.com	慈溪网
xiadele.com	下得乐模型库
aqsc.cn	中国安全生产网
lianzhong.com	联众游戏
jjxw.cn	九江新闻网
baby611.com	妈咪爱婴网
xsool.com	象山在线
clcmw.com	昌乐传媒网
xschu.com	北京小升初网
j1.com	健一网
bokee.net	企博网
esnai.com	中国会计视野
18touch.com	超好玩
g-emall.com	盖象商城
anqu.com	安趣网
gbs.cn	光波网
ythouse.com	烟台房地产网
tianjinwe.com	天津网
lzep.cn	泸州新闻网
pinble.com	拼搏在线彩票网
yaochufa.com	要出发旅行网
fishc.com	鱼C工作室
zxwindow.com	钟祥论坛
isay365.com	畅言网
3edu.net	3edu教育网
beihai365.com	北海365
apkbus.com	APKBUS
zolsky.com	天诺时空
taihainet.com	台海网
chelink.com	新锐车网
sdfyy.cn	苏州大学附属第一医院
xdkb.net	现代快报网
07430743.com	湘西生活网
sanjiaoli.com	三角梨
076299.com	河源论坛
3g.cn	3G门户
qdjimo.com	即墨信息港
dqccc.com	地球城
xfwed.com	幸福婚嫁网
800hr.com	英才网联
ppgame.com	《龙之力量》官方网站
51sxue.com	我要搜学网
mizhe.com	米折网
newhua.com	牛华网
t56.net	泰无聊
jxrcw.com	江西人才网
d17.cc	第一枪
qzone.com	QQ空间
rshao.com	融水好门户 
paipai.com	拍拍网
mytophome.com	满堂红地产网
5211game.com	11对战平台
shuiguobang.com	水果邦
coovee.net	环球厨卫网
fund123.cn	数米基金网
72g.com	72G.com手游网
domain.cn	域名城
jsinfo.net	江苏音符
151.hk	漫锋网 
xjpdf.com	迅捷PDF转换器
gxhc365.com	河池365
ruian.com	瑞安在线
3v.do	三维主机
100xuexi.com	圣才学习网
qd315.net	搜奇娱乐
duwenz.com	读文章网
57zhe.com	五七折
hbzkw.com	湖北自考网
fireemblem.net	火花天龙剑
hncu.net	湖南城市学院
iyuba.com	爱语吧
asianmetal.cn	亚洲金属网
chongbuluo.com	虫部落
cdysxy.com	四川传媒学院
tsingming.com	中国清明网官方网站
jrzj.com	金融之家
sdsgwy.com	公务员考试信息网
qudao.com	渠道网
bankofshanghai.com	上海银行
gotvg.com	游聚网
bbnews.cn	蚌埠新闻网
zhbit.com	北京理工大学珠海学院
jjmmw.com	基金买卖网
lanfw.com	蓝房网
lansedongli.com	蓝色动力
mimimama.com	密密麻麻婚纱摄影网
scdaily.cn	四川日报网
yuanlin365.com	中华园林网
sgou.com	搜狗网
gywb.cn	贵阳新闻网
changsha.cn	星辰在线
24k99.com	24k99黄金宝
7139.com	梦幻网络
ic98.com	百纳网
49you.com	49you网页游戏平台
ouou.cn	偶偶足球装备网
xhxsw88.cn	谜语网
chinapet.com	宠物中国
51hejia.com	和家网
0434.cc	四平信息港
gz163.cn	贵州信息港
0668.com	茂名资讯网
cnliti.com	立体中国
cqlp.com	梁平信息网
gitom.com	网即通
zixia.com	紫霞网页游戏平台
technode.com	动点科技
js118114.com	114便民网
locojoy.com	乐动卓越
zc173.com	增城家园
ccccltd.cn	中国交通建设
hugoboss.cn	HUGO BOSS
hegii.com	恒洁卫浴官网
wuyou.net	无忧启动
game5.com	跟我玩网页游戏平台
cnqiang.com	CHN强国网
jfinfo.com	丰华财经
djyule.com	DJ娱乐网
hf365.com	合肥在线
firefoxchina.cn	火狐中文网
3dmax8.com	3dmax吧
01hr.com	数字英才网
the9.com	第九城市官方网站
05wan.com	领我玩
mmb.cn	买卖宝
51yala.com	中国旅游网
118100.cn	爱音乐网
kameng.com	卡盟网
kq88.com	口腔医学网
1616.net	1616个人门户
gogodutch.com	荷乐网
okcard.com	OK会员俱乐部
kankanmi.com	看看米
cmiw.cn	中国机械社区
9588.com	9588旅行网
ttx.cn	天天新
lure123.com	路亚之家 
chekb.com	汽车口碑网
jiaoyubao.cn	教育宝
laiwu.net	莱芜在线
qqxoo.com	Q迅家园
guidaye.com	鬼故事
yangshitianqi.com	央视天气预报直播
izhuti.com	爱主题
cnsb.cn	中国设备网
xiaoma.com	小马过河教育网
csc86.com	华南城网
xiaot.com	XiaoT模型空间站
jiaonan.net	胶南信息港
med126.com	医学全在线
7fgame.com	起凡游戏
jcwcn.com	中国教程网
fengfeng.cc	峰峰信息港
168hs.com	黄山市民网
zhongguojie.org	中国结艺网
51jiaxiao.com	驾校中国
todgo.com	土地公官网
chinatibetnews.com	中国西藏新闻网
qqpk.cn	QQ空间加油站
simwe.com	中国仿真互动网
sseinfo.com	上证所赢富网
7808.cn	7808口碑创业网
114study.com	远播教育网
gtobal.com	际通宝
qsw.cn	中国奇石网
114ic.com	114IC网
leyoo.com	桃花源记
958shop.com	百信手机网
yntv.cn	云视网
0372.cn	安阳信息网
nvsheng.com	女生私房话
kaifu.com	开服网
lh168.net	临海在线
zufang.com	租房网
ihei5.com	爱黑武
goodjob.cn	中国俊才网
jianbihua.org	苗苗简笔画
lnzsks.com	辽宁招生考试之窗
itlun.cn	妈蛋表情网 
haima.com	海马汽车
fzg360.com	房掌柜
tshe.com	T社
iebook.cn	iebook电子杂志
ebdoor.com	一比多
roboo.com	儒豹手机搜索
aili.com	爱丽时尚
starlott.com	星彩网
bjbus.com	北京公交网
aqioo.com	阿启网
oyksoft.com	快乐无极软件园
fangjia.com	房价网
uggd.com	模具联盟网
zcinfo.net	诸城信息港
goufang.com	购房者网站
dmnico.cn	精彩动漫
2008php.com	欧莱凯设计网
yuzeli.com	心理成长
kunming.cn	昆明信息港
imust.cn	内蒙古科技大学
youkia.com	友嘉
addpv.com	搜客云优化软件平台
8fkd.com	银河演员网
laoyuegou.com	捞月狗
uimaker.com	UI制造者
3456.tv	火爆农资招商网
codoon.com	咕咚
hbdjk.com	水都网
itpub.net	ITPUB技术论坛
idtag.cn	身份通
niutuku.com	牛图库
huochepiao.net	火车票网
uccbikes.com	UCC官方 
uqee.com	游奇网络
meishi.cc	美食杰（曾用名）
qqjia.com	碧云轩
himedia.cn	海美迪官网
zznews.cn	漳州新闻网
xiashanet.com	下沙网
yuloo.com	育路教育
chinaticket.com	中票在线
hc3i.cn	中国数字医疗网
ggsafe.com	巨盾
lexiscn.com	律商网
theworld.cn	世界之窗浏览器
310v.com	大赢家体育
ewsos.com	医网
show160.com	演出网
cdyee.com	尚一网
huishangbao.com	会商宝
365kl.net	快乐网
45575.com	45575小游戏
my399.com	哈尔滨新闻网
7xz.com	七匣子
hx36.net	海峡钓鱼网
sgst.cn	上海研发公共服务平台
jyyuan.com	江阴信息港_
grfy.net	个人房源网
feiliu.com	飞流下载
27399.com	天宏一卡通
hq88.com	华企商学院
chinaluxus.com	中国奢侈品网
xiaoxiangrc.com	潇湘人才网
juren.com	巨人学校官方网站
70c.com	70度
2478.com	24趣吧
cnledw.com	中国LED网
dlxww.com	大连新闻网
dezhi.com	 德智教育
ljia.net	恋家网
blu-raydisc.tv	蓝光电影
ganhuoche.com	赶火车网
txwb.com	天下网吧
tiandaoedu.com	天道留学
blueair.cn	Blueair中国官方网站
xfsub.com	旋风动漫论坛社区
carcav.com	CarCAV中国汽车影音行业推广机构
dfhon.com	东方虹医学美容网
gdzijin.com	紫金论坛
job120.com	中国卫生人才网
rainmeter.cn	Rainmeter
stdaily.com	中国科技网
jzrb.com	焦作网
52che.com	我爱车网 
pack.cn	中国包装网
ehuatai.com	华泰保险集团
express8.cn	快递查询网
freekaoyan.com	免费考研网
bujie.com	步街网
zxhsd.com	浙江省新华书店集团
zww.cn	小荷作文网
baiqicms.com	社保查询网
vnet.cn	互联星空
baidajob.com	百大英才网
87870.com	87870虚拟现实网
find800.cn	方得网
jiandaoyun.com	简道云
hilizi.com	大连海力网
coco.cn	coco游戏平台
koudai.com	口袋购物
gaosubao.com	高速宝
huacolor.com	华彩软件站
job-sky.com	博天人才网
acftu.org	中华全国总工会网站
hy003.com	火云影视
yixuezp.com	中国医学人才网
uccbikes.com	UCC官方 
codoon.com	咕咚
cqcp.net	重庆彩票网 
52qj.com	中国范本网
goufw.com	盐城GO房网
jutubao.com	聚土网
njnews.cn	南京报业网
a963.com	中华室内设计网
taihainet.com	台海网
aqsc.cn	中国安全生产网
jiandaoyun.com	简道云
souxuexiao.com	搜学校 
gzfezx.com	广州市妇女儿童医疗中心
efesco.com	上海市对外服务有限公司
hy003.com	火云影视
ibeifeng.com	北风网
2478.com	24趣吧
youxiping.com	游戏瓶
jingpinke.com	国家精品课程资源网
ceconlinebbs.com	世界经理人论坛 
qp110.com	汽车配件110网
efesco.com	上海市对外服务有限公司
htu.cn	河南师范大学
gupiao8.com	股票吧
83133.com	百山探索
arinchina.com	增强现实中国
danlan.org	淡蓝网
21vianet.com	世纪互联
faisco.com	凡科
qqyy.com	全球医院网
52qj.com	中国范本网
jbzyw.com	鸡病专业网
rm93.com	如梦社区
yawin.cn	永安之窗
hnust.cn	湖南科技大学
pt791.com	莆田人才网
airchina.com	中国国际航空公司
huanle.com	欢乐互娱
kanshu.com	看书网
ipc.me	iPc.me
cnkrl.cn	假面骑士联盟
gzfezx.com	广州市妇女儿童医疗中心
china-ef.com	中国品牌服装网
xinhua08.com	新华08网
hfhouse.com	合肥房地产交易网
kehou.com	课后网 
hhk365.com	黄河口信息港
ibeifeng.com	北风网
52ch.cn	从化网
kshot.com	昆山论坛
jutubao.com	聚土网
smthome.net	SMT之家
wjdaily.com	吴江新闻网
0430.com	全球网站库
syyx.com	尚游游戏
epjob88.com	电力英才网 
cqcp.net	重庆彩票网 
zuiyouxi.com	最游戏
pengpeng.com	碰碰网
yzcn.net	百姓生活 
dipan.com	地盘网
chinaviolin.net	中国小提琴网
ciwong.com	习网
ybvv.com	零距离网络
hhxin.com	鸿新网
meizhou.com	梅州信息港
ahhouse.com	安徽房地产交易网
ku6.com	酷6网
mnu.cn	绵阳师范学院
diyifanwen.com	第一范文网
china35.com	炎黄网络
pt791.com	莆田人才网
haozip.com	2345好压官方网站
sm597.com	597三明人才网
tshe.com	T社
uimaker.com	UI制造者
zjtlcb.com	浙江泰隆商业银行
blu-raydisc.tv	蓝光电影
chinaviolin.net	中国小提琴网
srtong.com	上饶通
airchina.com	中国国际航空公司
87870.com	87870虚拟现实网
70c.com	70度
anhui365.net	徽网
ipc.me	iPc.me
3158.com	3158财富中国
arinchina.com	增强现实中国
zhixiaoren.com	直销人网
58food.com	58食品网
missyuan.com	思缘设计
hcbbs.com	海川网
clzg.cn	彩龙社区
zjtlcb.com	浙江泰隆商业银行
happigo.com	快乐购
xafc.com	新安房产网
geekfans.com	极客迷
mysipo.com	思博网
dzsm.com	广元广电网
vdolady.com	维度女性网
51cube.com	酷比魔方
999120.net	导医网
xxyw.com	凤凰语文
huoche.com	火车网
pk38.com	多多网游加速器
66163.com	福建之窗
3158.com	3158财富中国
showji.com	手机在线
bokon.net	博看网
by8.cn	宾阳吧
kuxun.cn	酷讯旅游网
tsdm.net	天使动漫论坛
qilindao.com	平潭麒麟岛网站
hvacr.cn	空调制冷大市场
zsedu.net	中山教育信息港
lfang.com	爱房网
211600.com	金湖论坛
cqcb.com	重庆晨报官方网站
newwise.com	任天堂世界
ssjzw.com	上上兼职网
1speaking.com	第一口语网
ruochu.com	若初文学网_
tvhuan.com	欢视网
lzszg.com	龙之声论坛
shunwang.com	顺网娱乐在线
nz86.com	中国女装网
t0001.com	第一茶叶网
czxiu.com	彩字秀
haoyun56.com	好运物流网
verypsp.com	V游网
ihk.cn	房王网
eurasia.edu	西安欧亚学院
zs8q.com	中式八球网
ditu6.com	导航地图
icpcw.com	电脑报官方网站
haozip.com	2345好压官方网站
teeqee.com	快玩游戏
xs163.net	萧然在线
huainet.com	淮网
mb5u.com	模板无忧
ziti88.com	草书在线转换 
138job.com	中国美容人才网
21dianyuan.com	世纪电源网
gzdsw.com	贵州都市网
fob5.com	环球外贸网站导航
lecu8.com	乐促吧
chaoshanren.com	潮汕人
juesheng.com	决胜网
pingshuxiazai.com	评书下载网 -
12308.com	汽车票
huas.cn	湖南文理学院
91y.com	91y游戏中心
aidiao.com	爱钓网
qcoco.com	橙子网
zx110.org	网络社会征信网
kuaiji.com	会计网
sm597.com	597三明人才网
172xiaoyuan.com	172校园活动网
meizhou.cn	梅州网
quna.com	去哪网
19yxw.com	19游戏网
juhangye.com	聚行业
m1905.com	电影网
bccn.net	编程中国
8da.com	欢乐八达社区
bikehome.cc	自行车之家
china-shufajia.com	中国书法家网
hcdj.com	DJ音乐厅
kingsunsoft.com	方直金太阳
srtong.com	上饶通
citic.com	中信集团
asthis.net	如斯 
dataodu.com	大陶都网
babihu.com	巴壁虎
eueueu.com	走遍欧洲
huisou.com	会搜
91981.com	易电
moonseo.cn	SEO研究中心官网
joy.cn	激动网
mmall.com	红美商城
cqyc.net	茶竹永川网
chinabaike.com	中国百科网
sddp.net	东平信息港
12530.com	中移动音乐门户
gxtv.cn	广西电视网
souxuexiao.com	搜学校 
prcedu.com	答疑网
kouyu100.com	口语100网络学习空间
easou.com	宜搜
508net.com	508网
zgzkw.com	中国篆刻网
dahebao.cn	大河报网
cuncun8.com	世纪之村
feifeishijie.com	 飞飞世界
oooxm.com	中国电信福建网厅厦门站
wm23.com	网络营销教学网站
ishangman.com	i尚漫
njnews.cn	南京报业网
8864.com	8864游戏
sdbeta.com	闪电下载吧
cranebbs.com	起重机在线 
huoshan.cc	霍山论坛
17m3.com	电魂梦平台
lolhelper.cn	英雄联盟隐藏分查询系统
seedit.com	播种网
running8.com	跑吧
chinese-luxury.com	中国奢侈品 
anseo.cn	Anseo博客
alihuahua.com	中国订花网
cfaspace.com	CFA space
xuekuaiji.com	学会计网
eebest.com	一贝网
dlmonita.com	国际蒙妮坦美容美发化妆摄影学校
copperhome.net	铜之家
chinafund.cn	中国基金网
any2000.com	无忧建站网
nsmovie.com	新南国影城
oppo.cn	OPPO官网社区
pcwl.com	鹏程万里人才网
wabuw.com	蛙步旅游网
91.cn	就医网
duba.net	金山毒霸官网
hhczy.com	行行出状元
haofz.com	 好房子网
yanzhaorc.com	燕赵人才网
china35.com	炎黄网络
appvv.com	维维网 
jingjia.org	京佳教育
diaoyu.com	钓鱼之家
ymt.com	一亩田
kechuang.org	科创网
gkstk.com	学优高考网
ainunu.com	爱努努
nbgy.com	宁波公运集团股份有限公司
meadin.com	迈点
51tie.com	51同城网 
91vst.com	VST全聚合官方网站
200.net	200网址大全
baoruan.com	宝软网
86ps.com	中国PhotoShop资源网
sucaitianxia.com	素材天下
chinaunicom.com	中国联通
lifan.com	力帆集团
wenkang.cn	闻康资讯网
rapidbbs.cn	锐普PPT论坛
7c.com	去查网
0535-0411.com	烟大船票网
univs.cn	中国大学生在线
wandaplaza.cn	万达广场官网
qizuang.com	齐装网
xdnice.com	好网
zhaoxi.net	朝夕网
eb80.com	亿商搜
gkong.com	中华工控网
hbrc.com	河北博才网
lezi.com	乐子网
anquan.org	安全联盟
131.com	131游戏之家
eyuyan.com	易语言汉语编程官方站
sports.cn	华奥星空
gzw.net	贵州网
drumchina.com	鼓手中国
exrpg.com	EXRPG论坛
rbc.cn	北京广播网
jiyili.net	记忆力训练网
vlongbiz.com	威龙商务网
njcgs.com	南京车管所
hao224.com	好团网
3dcp.cn	彩票界
0731go.cn	长沙网 
comicyu.com	漫域
zhuzhouwang.com	株洲网
fenlei168.com	分类168
nowec.com	环球经贸网
kaopu001.com	靠谱社区
333job.com	纳杰人才网
meyol.com	魅网
artx.cn	艺术中国
goufw.com	盐城GO房网
dianwoba.com	点我吧
lyge.cn	连云港市教育网
0708.com	欢畅游戏官网 
renhe.cn	人和网 
21boya.cn	博雅网
chinabike.net	中国自行车网
15880.com	拉拉交友网
woying.com	必赢彩票网
htsec.com	海通证券
snren.com	室内人
zzz4.com	株洲在线
hoopchina.com	虎扑篮球 
zizaike.com	自在客
trip8080.com	畅途网
nfsysu.cn	中山大学南方学院
c-ps.net	中国安防网
canpoint.cn	全品教学网
haochimei.com	汕头好吃妹团购网
ynpxrz.com	易贤网
yxx.cn	中国注塑网
0576qq.com	黄岩港社区
fdzcxy.com	福州大学至诚学院
cn-teacher.com	中国教师站
qinbei.com	亲贝网
cnkjz.com	中国课件站
daoguo.com	稻果旅游网
xiancity.cn	西安网
cailiao.com	中国材料网
newifi.com	newifi新路由
htpc1.com	HTPC原动力论坛
wlstock.com	万隆证券网
movshow.com	猫咪有约
sxrb.com	山西新闻网
jxrtv.com	嘉兴人网
fanfantxt.com	饭饭txt电子书
001jm.com	加盟一点通
tumuzhe.com	土木者论坛
jxcn.cn	中国江西网
2sche.cn	龙江二手车网
55168.cn	山地网
cs0799.com	萍乡城事网
bug.cn	穿帮网
hot1949.com	红色导航网
bdall.com	全保定网
pxtx.com	爬行天下宠物用品网上商城
ccement.com	中国水泥网
waaku.com	娃酷网 
zhongheedu.com	众合教育
changshifang.com	常识坊
xiancn.com	西安新闻网
chem365.net	中宇资讯
zhsc.net	中华诗词网
chuchujie.com	楚楚街
gnnu.cn	赣南师范大学
diandian.com	点点网
ctw.cn	长汀网
chinese.cn	网络孔子学院
xj163.cn	新丝路
ev123.com	易维企业服务网
baicai.com	百才招聘网
cslg.cn	常熟理工学院
sinohydro.com	中国水电建设集团国际工程有限公司
romantic214.com	浪漫网
pupuwang.com	铺铺旺
mztgame.com	巨人移动
dezhoudaily.com	德州新闻网 
qianshou.com	纤手人生官方网站
hbqc.com	蕲春论坛
dqdaily.com	大庆网
huaxi100.com	华西都市网
citygf.com	广佛都市网
zhaouc.com	壮游科技
npicp.com	新品快播网
cndzz.com	电子电路网
17utt.com	游聚网
northtimes.com	北方时空
hneeb.cn	湖南招生考试信息港
subaonet.com	苏州新闻网
95191.com	楼市通
hnticai.com	湖南体彩网
01fy.cn	第一时间房源网
52op.net	广场舞
pctowap.com	电脑上WAP网 
wj001.com	武进新闻网
i0415.cn	丹东供求网
imp3.net	iMP3随身影音
gg163.net	贵港视窗
169ol.com	169在线
zon100.com	中百商网
zhld.com	中华龙都网
brandcn.com	品牌联盟网
dongyingnews.cn	东营网
jinciwei.cn	金刺猬
chongwujiaoyi.com	卖狗网
runbible.cn	跑步圣经网
jxteacher.com	江西教师网
txwy.com	天下网游
sumisora.org	澄空学园
shunderen.com	顺德论坛
thsware.com	清华斯维尔官网
cqkx.com	点击开县
yodak.net	上海远大心胸医院
ico.la	在线ico图标制作
qlteacher.com	山东省教师教育网
xdwan.com	兄弟玩网页游戏平台
zsjjob.com	佛山人才网
daxues.cn	中国大学生网
haomagujia.com	号码估价网
ebscn.com	光大证券官网
gamefy.cn	游戏风云
datianmen.com	大天门论坛
nongyao001.com	中国农药第一网
thxy.org	无锡太湖学院
xatu.cn	西安工业大学
yxad.com	中国广告门户网
tjkx.com	糖酒快讯
kisdee.com	金蝶产品网
itongcheng.cc	桐城网
wushen.com	武神世纪官方网站
vx.com	微小网
9miao.com	9秒社团
dt123.net	东台人论坛
9ask.cn	中顾法律网
72177.com	天津在线
qjy168.com	勤加缘网
redatoms.com	飞石互动
zsnews.cn	中山网
bank-of-china.com	中国银行
lfnews.cn	廊坊新闻网
fzengine.com	服装工业网
hbsc.cn	河北搜才网
3s001.com	地信网
nhzj.com	宁海在线
jjjaaa.com	家园网
mothercare.com	Mothercare官方网站
52kd.com	52KD论坛
radiotj.com	天津广播网
zhongsou.com	中搜
fangxiaoer.com	房小二网
1866.tv	火爆兽药饲料招商网
lezhi.com	乐职网
youwo.com	游窝网
xiushuang.com	秀爽游戏
efw.cn	无锡房地产网
arting365.com	中国艺术设计联盟
vsuch.com	尚趣官方时尚网站
inewsweek.cn	中国新闻周刊
lbesec.com	LBE安全大师
qqzhi.com	QQ志乐园
vstab.cn	微攻略游戏
axnews.cn	安乡新闻网
gzszk.com	贵州省招生考试院
chinamac.com	苹果在线
inhe.net	银河网
bjsyqw.com	毕节试验区网
mfunz.com	魔趣os官网
kuaidadi.com	快的打车
foodqs.cn	中国食品产业网
999.com	999上网导航
179.com	179动漫游戏平台
mx3g.com	模型中国
kamigami.org	诸神字幕组
renai.cn	上海仁爱医院
175game.com	擎天柱游戏
sjedu.cn	松江教育信息网
dvedit.cn	DV视频剪辑论坛
weiphone.com	威锋网 
sosoyy.com	搜搜医药网
mangocity.com	芒果网
591wed.com	591结婚网
waduanzi.com	挖段子网
xj917.com	新疆综合网
xiaoshou.cn	销售网
cnjiaju.com	香河家具城官网
pc186.com	浦城生活网
starwarschina.com	星球大战中文网
feelcars.com	汽车探索
lvmae.com	绿蚂蚁
rrky.com	人人考研网
cyclist.cn	骑行者
hiwinwin.com	双赢网
173.com	Arc页游平台
erke.com	鸿星尔克品牌官方网站
96weixin.com	96微信网
ldnews.cn	娄底新闻网
tui18.com	推1把
qihuiwang.com	企汇网
sxgov.cn	黄河新闻网
ihaiyan.com	海盐网
links.cn	站长帮手网
icaidao.com	爱财道 
hulusi.com	少数民族乐器网
molingshu.com	 魔灵书星座网
qiyue.com	七月网
tieba.com	百度贴吧(曾用名)
blueidea.com	蓝色理想
zhuangjiba.com	装机吧U盘装系统官网！
link114.cn	买链帮手
7road.com	第七大道网页游戏平台
zzbank.cn	郑州银行
map456.com	456三维地图
e47.cn	江津在线
koreaxin.com	韩国新网
macauhr.com	澳门英才网
fjlottery.com	福建彩票网
118114.cn	百事购商城
diyring.cc	酷音铃声官网
toplicai.cn	鼎级理财网
dazhe5.com	打折网
51ielts.com	无忧雅思网 
hynews.net	淮安新闻网
zdcj.net	正点财经
yiss.com	壹时尚
teamtopgame.com	天拓游戏官网
fengsung.com	风尚中国网
0755zb.com	深圳珠宝网
51chuli.com	处理网
lihuashouji.com	李华手机
fqlook.cn	看福清
gamebar.com	游戏吧
ubetween.com	之间网
play.cn	爱游戏
zygames.com	臻游
wx6.org	文学乐
77l.com	齐齐乐手游网
julaibao.com	聚来宝官网
ieche.com	爱意汽车网
kmmc.cn	昆明医科大学
51youcai.com	山东有才网
qhzk.com	青海招考信息网
ytrain.com	引程网
chuguo.cn	出国在线
sxtvs.com	陕西网络广播电视台
msxf.net	陌上香坊
86516.com	彭城视窗
njdaily.cn	南报网
jpyoo.com	日本呦
vipfenxiang.com	VIP分享网 
funshion.com	风行网
bdinfo.net	保定热线
hnjcjt.com	湖南省机场管理集团有限公司
koiclub.net	中国锦鲤俱乐部
wooyun.org	WooYun乌云漏洞报告平台
antfortune.com	蚂蚁聚宝
cqksy.cn	重庆市教育考试院
souge.cc	搜鸽网
waduanzi.com	挖段子网
starwarschina.com	星球大战中文网
hopebiol.com	青岛海博生物
chuguo.cn	出国在线
xjkunlun.cn	昆仑网
cn-teacher.com	中国教师站
soxsok.com	搜学搜课
nbmetro.com	宁波轨道交通
hellokittypark.cn	凯蒂猫家园官网
btsou.org	BT搜索
av199.com	影音新时代
soharp.com	蓝调口琴网
tellingtech.com	天音科技
chaxun.la	查询啦
antfortune.com	蚂蚁聚宝
tianjihr.com	天基人才网
soharp.com	蓝调口琴网
strong-study.com	施强教育网
52njl.com	52农家乐乡村旅游网
togic.com	泰捷WEBOX官方网站
52samsung.com	三星手机论坛
nbmetro.com	宁波轨道交通
laoqianzhuang.com	老钱庄财经
av199.com	影音新时代
roadoor.com	融道网
17happy.cn	动画片大全
7755.com	7755小游戏
sportscn.com	华体网
yslzc.com	伊斯兰之窗
boxuu.com	盒子游戏
xjkunlun.cn	昆仑网
zj.com	浙江都市网
youxiduo.com	游戏多
sohu.net	搜狐企业云服务平台
hopebiol.com	青岛海博生物
tellingtech.com	天音科技
hellokittypark.cn	凯蒂猫家园官网
umpay.com	联动优势
fzbm.com	福州便民网
zzyjs.com	中国在职研究生招生信息网
ohdict.com	欧华词典 
zgjhjy.com	京翰教育
wushuangol.com	真三国无双OL
haotoufa.com	好头发网
beijing.cn	北京网
gtuu.com	改联网
vsharing.com	畅享网
snsyx.com	SNS游戏交友网
3ddl.net	3D动力网
huaian.com	淮安网
emagecompany.com	中国最大名录研究开发组织
diziwang.info	笛子网
cfanclub.net	电脑爱好者俱乐部
61f.com	六一风
dzyule.com	大众娱乐网
steelhome.cn	钢之家
handtrip.com	运筹网
shengyan.org	笔趣阁
3dcp.cn	彩票界
blueair.cn	Blueair中国官方网站
zgjhjy.com	京翰教育
161580.com	飞机票网上订票官网
xingzuopei.com	星座配对
egu365.com	依谷网
wushuangol.com	真三国无双OL
binzhi.com	宾至网
emagecompany.com	中国最大名录研究开发组织
easyvoa.com	EasyVOA 
zhuangjiba.com	装机吧U盘装系统官网！
diziwang.info	笛子网
ieche.com	爱意汽车网
macauhr.com	澳门英才网
peiyue.com	配乐网
italyclassico.com	意大利之家
luyouqiwang.com	路由器网
zaojiao.com	中国早教网
alltrip.cn	全程旅游网
yunvs.com	云财经
456ss.com	456手机浏览器
pxecn.com	无盘中国
hdtimes.cn	高清时代网
bokecc.com	CC视频
chaxun.la	查询啦
ourku.com	酷基金网
grabsun.com	聚生网管官网
139shop.com	北斗星手机网
soupingguo.com	搜苹果
easyvoa.com	EasyVOA 
egu365.com	依谷网
yinsha.com	碧海银沙
tcsisu.com	四川外国语大学重庆南方翻译学院
cndzq.com	中国电子琴信息网
china-flower.com	中国花卉网 
qsng.cn	青少年宫在线
ikaka.com	卡卡网
ednchina.com	电子技术设计
httpcn.com	网络中国
15w.com	要我玩
xingzuopei.com	星座配对
he-nan.com	河南网
igdzc.com	广东之窗
peiyue.com	配乐网
aiyidu.com	爱宜都网
161580.com	飞机票网上订票官网
binzhi.com	宾至网
luyouqiwang.com	路由器网
aibang.com	爱帮
cosmedecorte.com	黛珂官网
dtnews.cn	大同新闻网
cs-air.com	中国南方航空公司官网
rain8.com	雨枫轩
haitaocheng.com	海淘城
221700.com	丰县信息港
yonglibao.com	永利宝金融
souyidai.com	搜易贷
qqgexing.com	个性网
realqwh.cn	秋无痕论坛
reptilesworld.com	灵龟之家两爬论坛
jiyou.tv	基友网 
hiphop8.com	手机号码归属地查询
newxue.com	新学网 
lcjh.com	联建光电
molingshu.com	 魔灵书星座网
grabsun.com	聚生网管官网
yunvs.com	云财经
xcoodir.com	爱酷目录
i3zh.com	i3综合社区
souyidai.com	搜易贷
yonglibao.com	永利宝金融
gyedu.net	高邮教育信息网
iyingji.com	爱的影集
ttkvod.com	 天天看播放器官方下载站
qsng.cn	青少年宫在线
shengyan.org	笔趣阁
we54.com	新青年网
tongxiehui.net	童鞋会
bufan.com	不凡游戏网
iyingji.com	爱的影集
173zy.com	桌游世界
lcjh.com	联建光电
i3zh.com	i3综合社区
51saier.cn	浅蓝攻略网
dragonballcn.com	中国龙珠论坛
anzhuo.cn	安卓论坛
xmtv.cn	厦门广电网
besgold.com	百事高网
hw100.net	换物网
duoshitong.com	多事通便民查询网
gyedu.net	高邮教育信息网
wumart.com	物美
smgbb.cn	东方宽频
80end.cn	芭厘时尚网
newxue.com	新学网 
qbj.cc	青白江论坛
luaninfo.com	六安新闻网
zhijia.com	置家网
2125.com	2125小游戏
ttkvod.com	 天天看播放器官方下载站
ccpit.org	中国国际贸易促进委员会
cdcgames.net	CDC游戏集团
haoxiana.com	好险啊
hiphop8.com	手机号码归属地查询
asean168.com	东盟网
hebradio.com	河北广播网
voicedic.com	语音字典
yingshan.cn	英山在线
italyclassico.com	意大利之家
131458.com	131458淘宝信誉查询
ejoy.com	EJOY简悦
hicdma.com	天翼手机网
0776.cn	百色门户网
ccstock.cn	中国资本证券网
ptotour.com	深圳海外国际旅行社
xiyouxi.com	北京喜游戏科技有限公司
rugao35.com	如皋商务信息网
smskb.com	盛名列车时刻表
goodee.cn	时尚金鹰网
ttymq.com	天天羽毛球网
xaonline.com	古城热线
i8i8i8.com	爱吧网
wenbing.cn	问病网
myjob.com	我的工作网
sxkszx.cn	山西招生考试网
0513.net	今启网
dabin69.com	大斌健美论坛
52fx.cn	奉贤部落
xcoodir.com	爱酷目录
9tour.cn	九游网
compass.cn	指南针金融理财服务信息网 
b5m.com	帮5买
beiww.com	雅安北纬网
100.com	100教育
ruoshui.com	若水股票论坛
goulew.com	狗乐网
guilinhd.com	桂林红豆网
80710.com	第一比分网
17ok.com	财界网
lcudc.cn	聊城大学东昌学院
86game.com	86游戏平台
3737.com	3737网页游戏平台
kuaipan.cn	金山快盘
wst.cn	二泉网
1988.tv	中国农化招商网
php100.com	PHP100中文网
qm120.com	全民健康网
myzx.cn	名医在线
fengqiaoju.com	枫桥居
qqmcc.com	MCC精品
lewaos.com	乐蛙
zdaye.com	站大爷
anhui365.net	徽网
90vs.com	90vs体育
uusee.com	悠视网
sxxw.net	三峡新闻网
17ugo.com	优购物
wan5d.com	玩我的
hitvs.cn	南方电视台
soqi.cn	搜企网
gerfans.cn	德迷联盟 
nyist.net	南阳理工学院官
cmge.com	CMGE中国手游
shwyky.net	上海外语口译证书考试
hqcyw.cn	畅游网
webxgame.com	E侠网
diaoyan360.com	SDS
jzedu.cn	焦作市教育局
umiwi.com	优米网
ybbbs.com	宜宾泡菜坛
job256.com	苏州人才网
citycome.com	城市来了网
kuailebz.com	快乐编织手工编织网
100xiao.com	百校国际
popoho.com	泡泡花
thethirdmedia.com	第三媒体
mi168.com	200字日记大全
newclasses.org	新课程
qyrx.cc	青阳热线?
mcdvisa.com	美成达移民公司
8682.cc	8682赴韩整形网
cableabc.com	电缆网
shouji.com	手机王国 
yuqinge.com	豫青网
cn010w.com	中国网上音乐学院
yzwb.net	扬子晚报网
xutour.com	旭途旅游
89178.com	89178商机网
21cnhr.com	21世纪人才网
bitscn.com	中国网管联盟
sonyue.com	盛悦网
chinacqsb.com	重庆商报
fangyuan365.com	长沙365房产网
jxgdw.com	今视网
nzkd.com	南漳水镜论坛
xiaomayi.net	泸州小蚂蚁
yl1001.com	一览
ijiatv.com	爱家市场
kmguolv.com	云南省昆明国际旅行社
cngui.com	龟友之家 
catv.net	中广网
js-edu.cn	江苏招生考试
btsou.org	BT搜索
rekoo.com	热酷游戏
21cn.net	21CN企业应用
unqu.com	无趣
xout.cn	极限户外网
zzfish.cn	漳州小鱼网
17heli.com	合力网
cstong.net	长沙通
aqbtv.cn	安庆网络广播电视
goldzhan.com	淘金站
kids21.cn	中国未成年人网
rongbiz.com	容商天下
ywcec.com	远望手机网
shundecity.com	顺德城市网
hiao.com	好网
it007.com	IT007
lywww.com	临沂在线
cxhr.com	慈溪人才网
qdqss.cn	青岛全搜索网
zx98.com	中学数学网
lyy99.com	原野映像环球旅拍
panasonic.cn	松下电器中国官网
daqiso.com	大奇搜
zhuji.net	诸暨在线 
skymoons.com	天象互动
zbgl.net	淄博旮旯网
coffee.cn	中国咖啡网
hupub.com	北京论坛
oilchem.net	隆众石化网
dbank.com	华为网盘
hagaozhong.com	河南省普通高中综合信息管理系统
blgl8.com	on漫
kaoshi110.com	考试在线官方网站
jinmalvyou.com	金马国旅
n8n8.cn	多赢财富网 
upaidui.com	U派对
zwauto.com	中威汽车电子技术论坛
noyes.cn	游戏王国
cersp.com	新思考
cnzz.cn	中国站长
vdfly.com	青春娱乐网
adidas.cn	阿迪达斯(adidas)
gov.hk	香港政府一站通
120.net	120健康网
tx365.com	桐乡生活网
chizhouren.com	池州人网
365.com	365商城
playcool.com	冰动娱乐
zynews.com	中原网
hswzyj.com	海尔施特劳斯官网
pc811.com	电脑维修技术网 
jinghua.cn	京华网
hui800.com	惠800网
5281.net	5281网
52life.cc	52生活网
jnnc.com	新视听
qi-che.com	汽车中国网
wz16.net	深圳五洲中西医结合医院
dm123.cn	dm123
aigou.com	爱狗网 
blueshow.net	蓝色手机网
25yz.com	宜州论坛
zyxuan.org	紫云轩中式装修设计机构
17dm.com	一起动漫网
tibet3.com	中国藏族网通
soxsok.com	搜学搜课
alixixi.com	阿里西西
yaahe.com	合亚眼镜网
hner.cn	河南省基础教育资源公共服务平台
dongfeng.net	东风热线
diaoyuweng.com	钓鱼翁
ladymax.cn	LADYMAX时尚网
72ce.com	72策小游戏
51zjxm.com	51资金项目网
58game.com	58Game
dakao8.com	大考吧
xinzhou.org	忻州网
zhaoxi.org	 朝夕网
wfits.com	潍坊网
cnpenjing.com	中国盆景网 
0-6.com	妈妈说
4syy.com	宇宙探索网
tradesou.com	外贸搜
banzou999.net	伴奏999
ccdy.cn	中国文化传媒网
ireadercity.com	书香云集
1nongjing.com	第一农经
wuxi.cn	无锡阿福台
faayoo.com	发友网
ruoren.com	若人特价
sz1001.net	1001下载乐园
up360.com	向上网
4008885166.com	泰格旅游网
xiannvlou.com	仙女楼
yxlm.la	乐派LOL宝盒
6wang.cc	六网
hecha.cn	和茶网
cngaosu.com	中国高速网
zhongjiu.cn	中酒网
eachnet.com	易趣网
polycn.com	保利地产
iyaya.com	丫丫网
gaotiewang.com	高铁网
heze.cc	菏泽信息港
28tui.com	28推论坛 
51caiju.com	财聚网
ctrip.cn	携程旅行网
kuaijiren.com	会计人
o.cn	都市圈
lz520.net	阆中在线
jingzong.org	净宗学院
haha168.com	八目妖爆笑娱乐城
keniu.com	可牛官网
haobangni.com	好邦伲家政网
fuyuanweb.net	福缘网赚
hx95.com	华夏联盟
micblo.com	桌面围脖儿
gzbookcenter.com	广州购书中心官网
263xmail.com	263企业邮箱
jssjys.com	江苏省中小学教学研究室
txwm.com	天下网盟
fuyuanweb.net	福缘网赚
9tour.cn	九游网
shuhaha.com	书哈哈小说网
haha168.com	八目妖爆笑娱乐城
datiegun.com	大铁棍子相声网
banzou999.net	伴奏999
hswzyj.com	海尔施特劳斯官网
kuaijiren.com	会计人
beelink.com	百灵网
pcos.cn	PCOS技术论坛
gzbookcenter.com	广州购书中心官网
rongbiz.com	容商天下
gaotiewang.com	高铁网
linfen365.com	临汾365网
jszks.com	金手指考试网
zplay.cn	掌游天下ZPLAY官方网站
newmaker.com	佳工机电网
qipaoxian.com	起跑线早教网
yunpp.com	云鹏
guojitv.com	全国各地卫视频道同步直播
c029.com	西安热线
zerodm.tv	ZERO动漫网
lqwang.com	龙泉驾校
chunqiuwang.com	春秋网
xtfw.cn	仙桃房网
zdworks.com	正点科技
5dcad.cn	无维网
guoshi.com	果实网
qincai.net	星魂黄页网
comnews.cn	中国商务新闻网
fkw100.com	房客网
kjcity.com	会计城 
7878hk.com	香港攻略
suxiazai.com	速下载
dgqjj.com	家教网
okmk.com	风光订房网
lekan.com	乐看 
angeeks.com	安极网
douzaimai.com	都在买
gdcct.com	村村通商城
sdzqr.cn	章丘人信息网 
cnrencai.com	CN人才网
aadongman.com	AA国际动漫官方网站
jiaju.com	家居就
coolxap.com	酷七网
yb983.com	延边信息港
itxinwen.com	IT商业新闻网
datiegun.com	大铁棍子相声网
9ria.com	9RIA天地会
pcos.cn	PCOS技术论坛
tmhtour.com	天目湖旅游官网
whwd.com	文登之窗
qingrenw.com	玫瑰情人网
jiatx.com	家天下 
xuenb.com	学盟网
6pingm.com	6平米
szftedu.cn	福田教育网
shuhaha.com	书哈哈小说网
godeyes.cn	上帝之眼
4738.com	女人世界
cnlg.cn	龙港网
pincai.com	聘才网
yuceweb.com	中国预测网
xungou.com	寻购网
ny1988.com	女友网
tedahr.com	天津招聘
heima.com	黑马网
66club.cn	66club极速轮滑网
graphmovies.com	图解电影
graphmovies.com	图解电影
hljnews.cn	黑龙江新闻网
kuche.com	酷车网
qc99.com	99学习网
enjoyapps.org	秒杀助手
xgrb.cn	孝感网
haojiaolian.com	好教练网
gaotang.cn	高唐政务网
fengjing.com	风景网
vgooo.com	幻想曲通讯
thhome.net	太湖县家园网
ccaonline.cn	中国民用航空网
lgwy.net	联创世华
mofang.com	魔方网
feiyuhu.com	神武-飞鱼湖玩家社区
jinedu.cn	济宁教育网
xuelema.com	学了吗培训网
ltzxw.com	灵通资讯网 
imgo.tv	芒果TV
tripc.net	启程旅游网
3miao.net	三苗网
156580.com	易物流网
laixi.com	莱西信息港
enjoyoung.cn	人气美食官方网站
qwqt.net	宇宙奇闻奇图
tiantian.com	天天网
yilibabyclub.com	伊利奶粉
221600.cn	沛县便民网
skyworthbox.com	创维盒子官网
enjoykorea.net	乐在韩国
cjmx.com	超级明星娱乐网
hbqnb.com	河青网
hogacn.com	昊嘉在线
gxufe.cn	广西财经学院
jisiedu.com	月亮岛教育网 
antutu.net	安兔兔官方网站
365bh.cc	滨海论坛
67cha.com	手机号码定位软件
dacai.com	大彩网
mier123.com	米谈天下 
fengbao.com	风暴数码
artintern.net	艺术国际
goodweb.cn	无量香光
91town.com	第四城
fillseo.com	乐喵SEO综合查询
prcsteel.com	钢为网
zhaichong.com	宅虫网
9chun.com	景春网
lyss123.com	溧阳山水网
wshang.com	网商在线
0758net.com	四会论坛
0750rc.com	江门人才网
xiangw.com	襄阳网
ganzhe.com	甘蔗网
ptjy.com	莆田教育网
jinbaonet.com	金报网
ynhr.com	云南人才网
cfedu.net	赤峰市教育局
0570fc.com	衡州房产网
shuoqian.net	说钱网
cpigeon.com	中鸽网
jiyifa.cn	快速记忆法
0594123.com	莆田外贸之家
zudong.com	足动旅游网
99manga.com	久久漫画
haiqq.com	Y友乐园
23.cn	爱商网
shen88.cn	神巴巴
foyuan.net	佛缘
fftxt.com	天域苍穹
gaofen.com	高分网 
30edu.com	中国现代教育网
gqsj.cc	供求世界 
1news.cc	主流网 
ahlife.com	安徽生活网
niwota.com	圈网你我他
559.cc	559体育
peihua.cn	西安培华学院
gcchina.com	高淳热线
pingfenbang.com	评分榜 
apkhot.com	安热安卓论坛
lnairport.com	辽宁省机场管理集团有限公司
dadou.com	大豆生活网
hipiao.com	哈票网
conqueror.cn	gps全球卫星定位雷达服务网
hz3yy.com	杭州市第三人民医院
agui.cc	廉江阿贵网
16buzhi.com	教室布置网
fkw100.com	房客网
zjkonline.com	张家口在线
559.cc	559体育
56885.net	物流天下
lnairport.com	辽宁省机场管理集团有限公司
gloriahotels.com	凯莱酒店官方网站
kljiyou.com	快乐集邮商城
hz3yy.com	杭州市第三人民医院
daqo.com	大全集团
cswu.cn	重庆城市管理职业学院
16buzhi.com	教室布置网
ccgoufang.com	 长春购房网
nnn666.com	中国起名网
0663.net	揭阳网
kljiyou.com	快乐集邮商城
ycxy.com	山东英才学院
wasu.com	华数传媒官方网站
xingshu.com	星明网
zunyiol.com	遵义在线
glinfo.com	大宗商品网
csvclub.org	CSV德国牧羊犬俱乐部
dualwan.cn	Tomato DualWAN 
lingshi.com	中国零食网
sanhaostreet.com	网上三好街 
0437.com	辽源信息港
6hgame.com	仟游科技
08952.com	学行网
ejinqiao.com	金桥网
daqo.com	大全集团
3c3t.com	监理检测网
96hq.com	环球收藏网
28non.com	古诗词网
xunzai.com	迅载网
js0573.com	嘉善在线
indexedu.com	索学网
86wan.com	86wan网页游戏
mychg.org	时时彩出豹子
25dx.com	爱我大兴青年社区网
99lrc.com	速配歌词
gloriahotels.com	凯莱酒店官方网站
haofs.com	网聚房山
yanjiao.com	燕郊网城
56885.net	物流天下
fynews.net	阜阳新闻网
gushiw.com	固始之窗
goodbaby.com	好孩子科学育儿网
iabe.cn	立秋?驾培官网
nxnews.net	宁夏新闻网
9u8u.com	9U8U网页游戏
mz16.cn	民众健康网
cswu.cn	重庆城市管理职业学院
chinavisual.com	视觉中国 
8181.cn	8181军人网
sh7.com	商旗网 
chunyun.cn	春运网
yycqc.com	云阳人家
edu-hb.com	湖北招生考试网
qeto.com	酷兔英语
upol.cn	中国石油大学教育发展中心
zhubajie.com	猪八戒
joyoung.com	九阳官网
xze.cn	徐州教育
laijiuye.com	河北工业大学科技园
qdaeon.com	青岛永旺东泰商业有限公司
395.cn	沸点网
zbinfo.net	淄博信息港
lsgzn.com	兰舍硅藻泥官网
zhuannet.com	赚网
sinmeng.com	新梦网
wenyoutai.com	文游台
uua.cn	化石网
cnxianzai.com	现在网
gissky.net	GIS空间站
czinfo.net	常州信息港
81835.com	崇明生活网
qzedu.cn	泉州市教育局
0554cc.cn	淮南查查网
sasa123.com	洒洒动漫网
zjkonline.com	张家口在线
ioio.cc	ioio爱站网址大全
qina.cc	钦浪网
rushan.com	乳山热线
huarun.com	华润漆官网
sexjk.com	中国性健康网
doido.com	Doido爱度钻石网
maxpda.com	MAXPDA
molihua.net	茉莉花网
greenhua.com	绿化软件站
ma4r.com	骂人宝典
gxqzgjjfzx.com	南宁住房公积金管理中心区直分中心
tc.cn	太仓视窗
beat11.com	蛋七蛋舞
ourail.com	铁路在线
19see.com	影视下载基地
daqi.com	大旗网
tuotiansudai.com	拓天速贷
hustwenhua.net	文华学院
mllj.net	魅力庐江网
zlhome.com	中联地产网
jiangduw.com	江都论坛
sooyuu.com	搜娱中文网
godiy8.com	随ME网 
hustwenhua.net	文华学院
huarun.com	华润漆官网
changan.biz	长安车友会 
gxqzgjjfzx.com	南宁住房公积金管理中心区直分中心
ma4r.com	骂人宝典
bbq88.com	一路飘香
19see.com	影视下载基地
beat11.com	蛋七蛋舞
greenhua.com	绿化软件站
tuotiansudai.com	拓天速贷
ytyz.net	烟台一中
99lrc.com	速配歌词
redflag-linux.com	北京红旗软件有限公司
umgg.biz	环球石材
52ph.com	QQ千寻社区
huaiyangnews.com	淮阳新网
cnsec.org	暗组技术论坛
98znz.com	98指南针
miaolaoshi.com	苗圃医考网
changan.biz	长安车友会 
96822.com	大众出行网
wenxiu.com	文秀网
godiy8.com	随ME网 
ytyz.net	烟台一中
cqdj520.cn	垫江网
lecai.com	乐彩
shangol.cn	商洛在线
57fx.cn	57分享网
vjia.com	V 
nhaidu.com	海都网
umgg.biz	环球石材
ihitui.com	嗨推网
1f.cn	易房中国
haocw.com	好彩网
heshuicun.com	河水村
jzfjw.cn	江浙佛教网,
xielw.cn	写论文网
ahyx.net	岳西在线
gongboshi.com	工博士商城
435200.com	阳新新阳网
redflag-linux.com	北京红旗软件有限公司
aidonghai.com	东海生活网
brjt.cn	北人集团
aikan8.com	爱看吧亲子网
ynian.com	永年论坛
ultramanclub.com	奥特曼中国联盟
techan.com	特产优联
jzedu.net	晋中教育网
poobbs.com	涂鸦王国
0411cxd.com	长兴岛生活网
56ye.net	物友网 
cntronics.com	电子元件技术网
pinming.cn	品茗
435000.com	黄石信息港
ejiayu.com	佳域手机
lvping.com	驴评网
jianso.com	简搜
27.cn	美悦女性网
ailiuxue.com	免费留学
9d19.com	九易算命网
bjxueche.net	北京市驾驶人培训网络预约平台 
buscx.cn	掌上公交官网
zaoyang.org	枣阳资讯网
meishanren.com	眉山人网
0517w.com	涟水网
e974.com	珠江经济广播电台
ehomeday.com	房产之窗网
zhongcai.com	中财招商投资集团
mylike.com	美莱医疗美容医院
bjlmfq.com	北京罗马风情27?婚纱影楼
wper.com	威智网
jztele.com	中国联合网络通信有限公司焦作分公司
nduoshousi.com	N多寿司官方网站
10010sh.cn	联通沃购商城
315rx.com	315热线网
xueid.com	学号网
vxinyou.com	新游游戏 
gameyj.com	亿佳网络
dahangzhou.com	大杭州
baozang.com	宝藏网
guodu.com	国都证券
shimaoco.com	世茂股份
8dou.net	八斗文学
sopopo.com	搜泡泡
jxcfs.com	江西外语外贸职业学院
qijee.com	QiJee网页游戏平台
hltm.cc	红旅动漫
sdwz.cn	苏州大学文正学院
easthope.cn	东方希望集团有限公司
hqdoor.com	虹桥门户网
tlnews.cn	铜陵新闻网
saike.com	赛客虚拟家庭
kuhao360.com	酷好360网址导航
xsjk.net	携手健康网
xfsb119.com	中国消防设备网
aceona.com	红桃网
caenet.cn	CAE联盟
heilanhome.com	海澜之家
173kt.com	173卡通
caomeipai.com	草莓派化妆品商城
tj-football.com	天津足球网
3436.com	天天娱乐网
aiwenwo.net	爱问时尚网
wudingfadian.com	屋顶发电网
amazfit.com	AMAZFIT
lansurcn.com	LANSUR兰瑟官方网站
chun-wang.com	春旺环保
tl100.com	天利网
tielu.org	中国铁路网
cakeking.cn	采蝶轩
0577job.com	温州人才招聘网
288job.cn	寿光人才网
mylike.com	美莱医疗美容医院
315rx.com	315热线网
lansurcn.com	LANSUR兰瑟官方网站
366club.com	任我行网
tlnews.cn	铜陵新闻网
288job.cn	寿光人才网
nduoshousi.com	N多寿司官方网站
amazfit.com	AMAZFIT
aceona.com	红桃网
15666.com	叶子猪手游通
3436.com	天天娱乐网
jym56.cn	加运美速递有限公司
guodu.com	国都证券
tao66.com	淘六六淘宝论坛
aiqiyivip.com	乐享网
jym56.cn	加运美速递有限公司
weibodangan.com	微博档案
smmail.cn	市民云
cngulu.com	咕噜网
dazhangqiu.com	大章丘网
isapt.com	天下养生网
txtbbs.com	TXT小说网
8855.org	帮我网
phedu.net	平湖教育网
bdwm.net	北大未名BBS
366club.com	任我行网
uban.com	优办
ncfz.com	南川方竹论坛
waigame.com	外游网
im200.com	蝴蝶谷娱乐网
jielongdaquan.com	接龙大全 
haining.com	海宁网
hezhou520.com	贺州520
scstock.com	中航证券
7mo.cc	7MO婚嫁网
nfdaily.cn	南方报网
bangcn.com	互帮网 
0470a.com	呼伦贝尔火网
bbq88.com	一路飘香
pahou.com	-爬猴网
fjxiehe.com	福建协和医院 
cpcrugao.cn	中共如皋市委新闻网
hnjing.com	湖南竞网智赢网络技术有限公司
gaoan.net	高安信息网
wkjjk.com	万可佳商城官网
yisier.com	益思尔科技
chun-wang.com	春旺环保
jxfczx.cn	江西福彩网
360tiku.com	360题库网
rencai5.com	打工人才网
wjedu.net	武进教育信息网
beijianggzn.com	北疆硅藻泥
emaozi.com	帽子网
66u.com	66游手机游戏第一门户
gxfdc.cn	住朋网
15666.com	叶子猪手游通
qqxcl.com	新材料交易网
uban.com	优办
yiyiclub.com	依依社区美图网 
fqxww.cn	福清新闻网
360tiku.com	360题库网
yisier.com	益思尔科技
fjxiehe.com	福建协和医院 
xfsb119.com	中国消防设备网
cakeking.cn	采蝶轩
nfdaily.cn	南方报网
hdzc.net	邯郸之窗
svgoptronics.com	苏大维格
lumiai.com	卢米埃影城
jxfczx.cn	江西福彩网
ncfz.com	南川方竹论坛
emaozi.com	帽子网
imeee.cn	爱美丽
lumiai.com	卢米埃影城
whccb.com	威海市商业银行
tkgame.com	天空游戏网
tfysw.com	美食城
abab.com	ABAB小游戏
vojs.cn	江苏广播网
fqxww.cn	福清新闻网
langfang.net	廊坊热线 
hzsp.com	杭州野生动物世界
yiyiclub.com	依依社区美图网 
99fob.com	九九外贸论坛
dragontv.cn	东方卫视官方网站
xunbiz.com	中国商务网
bumiu.com	不谬网
xyrs.cn	咸阳市人力资源和社会保障网
ageqin.cn	核心科技
chengzhou.net	成州网
61k.com	 61K手游网
dvdzm.com	汽车导航网
ourjz.com	金寨在线
ekas.cn	e卡售
tm51.com	童梦无忧网
czgjj.net	沧州市住房公积金管理中心
fundxy.com	 基金互动网
wg999.com	外挂999传奇私服发布网
udangjia.com	U当家官网
noyes.cn	游戏王国
qydsj.com	企业大世界
hzsp.com	杭州野生动物世界
052360.com	辛集在线
fx898.com	奉新信息网
everygold.com	普金科技
lnkjw.com	辽宁会计网
whccb.com	威海市商业银行
sjyyy.com	冬虫夏草
zhifa.cc	雍禾植发医院官网
poobbs.com	涂鸦王国
xunbiz.com	中国商务网
tkgame.com	天空游戏网
o2mania.com	O2MANIA-DJMAX劲乐团单机版模拟器
softjie.cn	软件街
jiandan100.cn	简单学习网
cjxtv.com	江西电视台
bn13.com	13号避难所
czgjj.net	沧州市住房公积金管理中心
hnjing.com	湖南竞网智赢网络技术有限公司
shimaoco.com	世茂股份
cdrjob.com	成都铁路局人才交流网
bn13.com	13号避难所
ls520.net	凉山在线
tos.cn	TencentOS官网
jiandan100.cn	简单学习网
lj-bank.com	龙江银行
udangjia.com	U当家官网
052360.com	辛集在线
lnkjw.com	辽宁会计网
gupzs.com	股票之声
fx898.com	奉新信息网
cdrjob.com	成都铁路局人才交流网
sjyyy.com	冬虫夏草
500178.com	500178电竞网
ngnews.cn	宁国新闻网
43yl.com	时尚娱乐网
gpcgd.com	广东省政府采购中心
jsr.cc	嘉善生活网社区
gdlzsc.com	连州视窗
lanzhou.cn	中国兰州网
dzrcd.com	自然科技
chinaswim.com	中国游泳网
topzj.com	页游之家
zdiao.com	中国调查网
fview.cn	爱否FView
527100.com	郁南E家
ufidawhy.com	用友软件试用站
anhuiqq.cn	QQ之家
hdzc.net	邯郸之窗
qiuyi120.com	求医在线网
lianshui.cn	涟水在线网
aicairen.com	爱彩人彩票网
softjie.cn	软件街
isapt.com	天下养生网
43yl.com	时尚娱乐网
66zb.net	66直播网
301688.com	三帝贸易网
ufidawhy.com	用友软件试用站
broadex-tech.com	博创科技
gpcgd.com	广东省政府采购中心
aadongman.com	AA国际动漫官方网站
sdzzjj.com	枣庄交巡警信息网
dongpingren.com	东平生活网
wenzikong.cc	文字控
ourjz.com	金寨在线
527100.com	郁南E家
anhuiqq.cn	QQ之家
bluehn.com	蓝网
xtzrc.cn	泰州人才网
dju8.com	劲爆DJ嗨曲网
zgkw.cn	康网
818long.com	迎龙文化
xsxlt.com	香溪在线 
o2mania.com	O2MANIA-DJMAX劲乐团单机版模拟器
mylegist.com	法律界
huaweidevice.com	华为消费者业务官网
66zb.net	66直播网
dawenling.com	大温岭
dongpingren.com	东平生活网
qydsj.com	企业大世界
sdzzjj.com	枣庄交巡警信息网
onlyjp.cn	 昂立日语
eju.cn	易居网
liao1.com	辽一网
hxland.com	华夏土地网
hnht56.com	鸿泰物流
huxianwang.com	户县网
newsyc.com	宜春新闻网
307hospital.com	中国人民解放军307医院
875.cn	生意街招商加盟网
jiahewushe.com	嘉禾舞蹈工作室
onlyjp.cn	 昂立日语
307hospital.com	中国人民解放军307医院
xtzrc.cn	泰州人才网
beijianggzn.com	北疆硅藻泥
zdiao.com	中国调查网
cavtc.cn	长沙航院
11ziyun.com	中浩紫云
xsxlt.com	香溪在线 
wxrc.com	无锡人才网
huxianwang.com	户县网
haouc.com	壮游奇迹MU特色专区官方网站
tengfang.net	腾房网
rczp.org	唐山人才网
zhifa.cc	雍禾植发医院官网
dangzhi.com	当知作文网
nbweekly.com	南都周刊
horizon-china.com	零点研究咨询集团
8tennis.com	网球吧
moon-soft.com	月光软件站
quhua.com	趣话网
laxjyj.com	隆安教育信息网
liyedai.cn	立业贷
xiangsw.com	内蒙古响沙湾旅游景区
wxrc.com	无锡人才网
sisen.com	森森工作室 
jiahewushe.com	嘉禾舞蹈工作室
cczq.com	川财证券
wg999.com	外挂999传奇私服发布网
117go.com	在路上
3023.com	 3023
lianwifi.com	WiFi万能钥匙
shijiemil.com	世界军事网
sykee.cc	赛克电动车
3310.com	好卓网
xiaocangyouku.com	小苍优酷空间
jj0833.com	夹江在线
ldqxn.com	亮点黔西南
fifm.us	FIFM收音机
lzbd.com	临淄佰渡信息网
sisen.com	森森工作室 
cczq.com	川财证券
sykee.cc	赛克电动车
ldqxn.com	亮点黔西南
51rrkank.com	51人人看电影网
ailinzhou.com	林州网
moon-soft.com	月光软件站
souyute.com	搜于特
iibq.com	精明眼在线漫画
shijiemil.com	世界军事网
liyedai.cn	立业贷
horizon-china.com	零点研究咨询集团
xiaocangyouku.com	小苍优酷空间
hnht56.com	鸿泰物流
lzbd.com	临淄佰渡信息网
dzrcd.com	自然科技
xiangsw.com	内蒙古响沙湾旅游景区
chinaqigong.com	中华气功网 
cmol.com	工程机械在线
tnyoo.com	天之游
beifabook.com	北发图书网
qqxcl.com	新材料交易网
home616.com	家园小站
broadex-tech.com	博创科技
liyangrc.com	溧阳123人才网
269.net	古城热线 
zgqczj.com	中国汽车装具网
zq1.cn	振强科技
ankang.net	安康热线
20ju.com	草根网
jinshangrc.com	晋商人才网
lavago.com	拉拉勾旅游网
naol.cc	北美在线
11ziyun.com	中浩紫云
liyangrc.com	溧阳123人才网
bajierifu.com	八戒日付网
rencai5.com	打工人才网
jj0833.com	夹江在线
ves100.com	威尔斯陶瓷官网
zq1.cn	振强科技
20ju.com	草根网
naol.cc	北美在线
pizi.cc	痞子游戏社区
nyrsksw.com	南阳人事考试网
ahrtv.cn	安徽广播电视台
playcrab.com	玩蟹科技
ddianle.com	上海点点乐信息科技有限公司
ves100.com	威尔斯陶瓷官网
cavtc.cn	长沙航院
hwebook.cn	汉王书城
wenzikong.cc	文字控
netor.com	网同纪念
pizi.cc	痞子游戏社区
beelink.com	百灵网
nyrsksw.com	南阳人事考试网
ailinzhou.com	林州网
lhcom.cn	沙澧信息港
somenmian.com	搜门面网
yyfdcw.com	岳阳房地产网
91d2.cn	暗黑战网
everygold.com	普金科技
2165588.com	莘县综合信息门户网站
goodwd.cn	good直播
huaien.com	怀恩网
bajierifu.com	八戒日付网
dm530.com	风车动漫
xafish.com	西安钓鱼网 - 西钓网
dingdi.com	鼎砥投资网
job250.com	250常州人才网
shanglin.net	上林网-
155.cn	手游天下
cctcct.com	深圳福田康辉旅行社
xxdm.com	星星动漫网
dsqq.cn	都市圈圈
taodu.com	陶都网
525zb.com	珠宝之家
nextvip.cn	国家职业资格考试网
pai-hang-bang.com	网络排行榜
svgoptronics.com	苏大维格
610115.com	临潼之窗
aigame.com	极光互动娱乐平台
jiukuaiyou.com	九块邮
cn314.com	中国派CN314智能生活网
sytlw.com	沈阳铁路网
haidiao.com	中国海钓网
0379home.com	洛阳房地产信息网
hhhtgajt.com	呼和浩特市公安局交通警察支队
beijing518.com	北京中考网
8714.com	87下载站
qhdvtc.com	秦皇岛职业技术学院
lillychina.com	礼来中国
xwstore.cn	星外转铺
jiaju.cc	中国家具网
bjsjsyly.com	北京石景山游乐园
gohoo.cn	歌华宽带
16movies.cn	一路电影网
daanwang.com	思路岛学习网 
pztuan.com	品质团
jinianri.com	纪念日官网
yuucn.com	电脑学习网
ltggc.com	山东润达无缝钢管厂
949949.com	949健康网
qznews360.com	青州新闻网
wdsjz.com	我的石家庄生活服务网
mczx.cn	蒙城在线 
wicresoft.com	微创软件
maicai.cn	买彩网 
v007.net	西江明珠
wicresoft.com	微创软件
gohoo.cn	歌华宽带
wjjw.cn	中国挖掘机网 
610115.com	临潼之窗
bjsjsyly.com	北京石景山游乐园
jinianri.com	纪念日官网
lillychina.com	礼来中国
0416job.com	锦州人才网
yulindayday.com	玉林天天网
sgmart.com	苏州工艺美术职业技术学院
16movies.cn	一路电影网
aisiren.com	爱丝人
jiaju.cc	中国家具网
qhdvtc.com	秦皇岛职业技术学院
baidu.dj	百度DJ网
iibq.com	精明眼在线漫画
0416job.com	锦州人才网
psybook.com	心理学之家
aisiren.com	爱丝人
piaohangzhou.cn	考试家园
zpol.cn	昭平在线
lnfisher.com	辽宁钓鱼网
mingba.cn	名霸测名起名网
yulindayday.com	玉林天天网
9199.com	9199网页游戏
52jj.net	我爱夹江网
0575zhuji.com	诸暨E网
sgmart.com	苏州工艺美术职业技术学院
lameng.net	拉蒙短信网
51jiameng.com	我要加盟网
hzlp.com	临平网
0377auto.com	南阳汽车
kongjun.com	空军网 
kadang.com	卡当网
ssfeng.com	榆林塞上风
wmb2b.com	中国万贸网
pyzhufang.com	濮阳住房网
5usport.com	5U体育
wzpy.com	平阳信息网
637600.com	仪陇在线
man189.com	帅哥网
bf35.com	中国泵阀网
zshouyou.com	中手游-中国手游网
cjxtv.com	江西电视台
5800.com	银天下石油
sdyypt.net	山东省药品集中采购网
301688.com	三帝贸易网
powereasy.net	动易CMS
missevan.cn	M站
zjgzp.com	张家港人才网
xinjiang.cn	新疆维吾尔自治区人民政府
ahiib.com	安徽国际商务职业学院
yezizx.com	北京叶子整形美容医院
yp001.com	邮币卡互动网
pyzhufang.com	濮阳住房网
ahiib.com	安徽国际商务职业学院
shyrcw.com	沭阳人才网 -
ltggc.com	山东润达无缝钢管厂
5800.com	银天下石油
wmb2b.com	中国万贸网
powereasy.net	动易CMS
it892.com	电脑技术网
xingren.com	杏仁医生
168zzw.com	中国药材种植网
chengduair.com	深冷股份
yezizx.com	北京叶子整形美容医院
daanwang.com	思路岛学习网 
wood-china.com	中国木材网
bf35.com	中国泵阀网
wood-china.com	中国木材网
168zzw.com	中国药材种植网
rca8.com	荣昌人才网
goldstone-group.com	金石东方
jttv.net	交通观察网
ahrtv.cn	安徽广播电视台
mobile-open.com	阳和移动开发
ttcf.com	天天财富网 
huxi.cc	湖西网
shyrcw.com	沭阳人才网 -
mingrent.com	lol游戏名人堂
ksnews.cn	昆山新闻网
whyuntai.com	芜湖运泰汽车运输集团有限责任公司
ecaidian.com	蔡甸论坛
xda.cn	XDA智能手机网
rca8.com	荣昌人才网
cwb11.com	中国水利水电第十一工程局有限公司
beijing120.com	北京急救中心
zjgzp.com	张家港人才网
zshouyou.com	中手游-中国手游网
mobile-open.com	阳和移动开发
ttcf.com	天天财富网 
ksnews.cn	昆山新闻网
fishcn.com	中钓网
cctxm.com	厦门康辉国际旅行社
xyrsks.com	信阳人事考试网
lsbankchina.com	莱商银行
whpx.net	求艺培训网
qdnpt.com	黔东南民族职业技术学院
ahzyw.com	枞阳论坛
huajinsc.cn	华金证券
fishcn.com	中钓网
qdnpt.com	黔东南民族职业技术学院
yeesha.com	一生一纱
newsxc.com	宣城新闻网
lsbankchina.com	莱商银行
souyute.com	搜于特
zhaochafa.com	找查发信息网
ak.cc	畅想游戏
0317hy.com	任丘华油信息网
whpx.net	求艺培训网
villachina.com	搜房别墅网
hnjkw.net	河南健康网
auwxw.com	哎呦文学网
bzrc.cn	滨州人才网
chinassbc.com	上海旅游集散中心
6000y.com	一天学会FLASH网
0790tg.com	新余团购网
139life.com	苏州生活网
haoju.cn	好居网
gzuc.net	广州大学城网
xacxxy.com	延安大学西安创新学院
vboly.com	微薄利
cslgzj.com	长沙理工大学就业信息网
xwie.com	徐闻网
dayuonline.com	大余在线
zhigou.com	智购网
xuexigang.com	学习港
beijing120.com	北京急救中心
sma.so	Sma.so神马网址导航
pzzx.com	邳州在线
elanw.com	e览网
corpease.net	尚易企业邮箱
jgaoxiao.com	聚高校
bilibili.cn	哔哩哔哩弹幕视频网
ouou.com	偶偶网
it892.com	电脑技术网
beicity.com	北城网
wjjw.cn	中国挖掘机网 
cwb11.com	中国水利水电第十一工程局有限公司
pgos.cc	 系统家园
jiaozhou.net	胶州网
playamaya.cn	玛雅海滩水公园
nd090.com	宁都州人网 
0566cc.cc	池州查查网
iygw.cn	阳光网
4933.cn	4933小游戏
dfdaily.com	东方早报网
cl0579.com	辰龙游戏官网
quxizang.com	去西藏旅行网
cngulu.com	咕噜网
liaoing.com	聊宅网
51915.cn	普工网
sisiww.com	上海四四论坛网
yifucj.com	一富财经网
sucai.com	素材网
taodangpu.com	淘当铺
xinjiang.cn	新疆维吾尔自治区人民政府
hmplay.com	海门玩乐网
110bbs.com	110BBS论坛
huajinsc.cn	华金证券
dongcheshike.com	动车时刻表
jiukuaiyou.com	九块邮
taodangpu.com	淘当铺
beicity.com	北城网
51915.cn	普工网
sucai.com	素材网
taodake.com	淘大客
mnwww.com	闽南之窗
hyxzx.net	衡阳县在线
bossco.cc	博世科
uemap.com	地图在线
yuchengyizhan.com	高邮盂城驿论坛
youxiuhui.com	优秀会
xcedu.net	宣城教育体育信息网
uucin.com	悠悠
th38.com	涩女人网
sjszl.cn	设计师之路
yzwb.com	扬州晚报网
yinker.com	银客网官网
upcd.org	成都向上
zmlearn.com	掌门1对1
cqdzjw.cn	重庆市大足区教育委员会
yalj.net	临沮论坛
bossco.cc	博世科
6711.com	6711网页游戏平台
dongcheshike.com	动车时刻表
shniec.com	上海新国际博览中心
qndb.net	青年导网
haodewap.net	电脑上wap网
vmhelp.com	ok啦导航网
jiechan5.com	姐馋网
110bbs.com	110BBS论坛
czolgame.com	珠海成长科技有限公司
9355.com	开心创业网
gwinbody.com	集运宝典
guijob.com	桂才网
snfce.cn	睢宁房产网
028nb.com	028牛逼邪恶吧
zhxjyw.com	中学教育网
xyrsks.com	信阳人事考试网
sjzmc.cn	石家庄医学高等专科学校
xjyrcw.com	江阴人才网
lpswz.com	中国六盘水网 
fish3000.com	FISH3000 
hzbx.com	汉中生活网
autochongqing.com	2015中国重庆国际汽车工业展览会（重庆国际车展）
ez01.cn	鄂州第一网
osbkj.com	佛山欧仕堡科技有限公司
baozupo.com	包租婆
shniec.com	上海新国际博览中心
395.cn	沸点网
shoujidai.com	手机贷
zmlearn.com	掌门1对1
cqdzjw.cn	重庆市大足区教育委员会
0818work.com	达州人才网
lpswz.com	中国六盘水网 
snfce.cn	睢宁房产网
zhxjyw.com	中学教育网
gwinbody.com	集运宝典
xjyrcw.com	江阴人才网
sma.so	Sma.so神马网址导航
jjwxc.cn	晋江原创网
cslgzj.com	长沙理工大学就业信息网
chinassbc.com	上海旅游集散中心
jiechan5.com	姐馋网
zjlt.cn	网连天下旅游
gl110.com	古蔺郎网
autochongqing.com	2015中国重庆国际汽车工业展览会（重庆国际车展）
xichengwang.com	锡城网
taocijiaju.com	中国陶瓷家居网
china-soyea.com	索伊电器官方网站
baozupo.com	包租婆
9355.com	开心创业网
qilurencai.com	齐鲁人才网
sdeer.in	圣迪奥
haodewap.net	电脑上wap网
pgos.cc	 系统家园
028nb.com	028牛逼邪恶吧
ctsto.com	深圳口岸中旅官网_
yuchengyizhan.com	高邮盂城驿论坛
auwxw.com	哎呦文学网
htattoo.com	好纹身网
guijob.com	桂才网
goldstone-group.com	金石东方
ouou.com	偶偶网
suofeiya.com	索菲亚衣柜官网商城
ez01.cn	鄂州第一网
osbkj.com	佛山欧仕堡科技有限公司
gl110.com	古蔺郎网
taocijiaju.com	中国陶瓷家居网
shoujidai.com	手机贷
suofeiya.com	索菲亚衣柜官网商城
taofang.com	淘房网
gasshow.com	博燃网
fjcredit.com	福建省企业信用网
daqing.net	大庆信息港
qhdnews.com	秦皇岛新闻网
zjlt.cn	网连天下旅游
ctsto.com	深圳口岸中旅官网_
htattoo.com	好纹身网
g2us.com	 艾格拉斯科技（北京）有限公司
hmplay.com	海门玩乐网
sdeer.in	圣迪奥
china-soyea.com	索伊电器官方网站
job9151.com	高校就业联盟网
epweike.com	一品威客网
zg05.com	中国陵网
xichengwang.com	锡城网
chengduair.com	深冷股份
0818work.com	达州人才网
051jk.com	健康安全网
lwxsw.org	乐文小说网
gz4u.net	LNMP一键安装包 
58xs.com	58小说网
erya100.com	尔雅通识课
meinv.cn	美女伊甸园
yhgame.cn	远航游戏中心
tt919.com	吴江当家网
zhuangshi5.cn	装饰屋网
168xiezi.com	国际鞋业网
zhengzhoulvxing.com	河南康辉国际旅行社
logopay.com	乐贝
131qz.com	 拾三意强者
3595.com	3595游戏娱乐平台
heyuan77.com	河源东江网
xingren.com	杏仁医生
kaizhan.com	开战传奇
chepin88.com	全球汽车用品网
9191mr.com	经典整形网
77hh.com	女人伊甸园
51zuoche.com	我要坐车网
51cnhr.com	潜力英才网
cnwuhu.com	芜湖网
b2bdq.com	b2b网站大全
lxxdyzx.com	安徽省利辛县第一中学
nanhuazaobao.net	南华早报网
touxing.org	偷腥网
0769auto.com	东莞汽车网
shouyao8.com	兽药吧
im520.com	艾米交易论坛
580k.com	帮看网
sdjtaq.cn	山东道路交通安全网
0538fc.com	肥城网
5ol.com	五网
sowu.com	搜物网
yxjob.net	深圳永信人才网
tjcyts.com	天津中国青年旅行社有限公司
niupu.com	牛铺
haiedu.cn	海教网
china-bdh.com	黑龙江省北大荒米业集团有限公司
lygl.net	临沂国际旅行社有限公司
jn256.com	渠道商城
wodeweilai.com	我的未来网
madajiefood.com	马大姐食品
daomin.net	秦皇岛岛民网
lwxsw.org	乐文小说网
tjportnet.com	天津港物流信息网
shouyao8.com	兽药吧
sdjtaq.cn	山东道路交通安全网
iweimeijuzi.com	唯美句
b2bdq.com	b2b网站大全
qdguoyang.com	青岛国阳淘气堡
yeesha.com	一生一纱
ahwhedu.com	五河教育网
51cnhr.com	潜力英才网
lygl.net	临沂国际旅行社有限公司
jn256.com	渠道商城
lxxdyzx.com	安徽省利辛县第一中学
yikao.cn	中国艺考网
qingdaomedia.com	青岛传媒网
mklm.cn	每克拉美钻石网
jxjatv.com	吉安网
tjportnet.com	天津港物流信息网
yipux.com	重庆市万州区中学
88fl.com	88分类信息网
steel-spot.com	不锈钢现货网
phpcms.name	好书推荐排行榜
dj92cc.com	DJ轮回舞曲网
97rx.com	三智文学 
373.cn	新乡信息港
mklm.cn	每克拉美钻石网
wodeweilai.com	我的未来网
dp168.com	眉山东坡论坛
yipux.com	重庆市万州区中学
csx.cn	星沙论坛
kaizhan.com	开战传奇
ins110.com	意时网
9191mr.com	经典整形网
china-bdh.com	黑龙江省北大荒米业集团有限公司
sowu.com	搜物网
fjcredit.com	福建省企业信用网
gdrsrc.com	广东人事人才培训网
jxjatv.com	吉安网
tjcyts.com	天津中国青年旅行社有限公司
sojoline.com	双杰电气
qqmcc.org	QQMCC论坛
ok183.com	奇梦网
huaao-trust.com	华澳信托
newdu.com	新都网
s1979.com	中国时刻网
3j3f.com	三警三匪杀人游戏网
haxiu.com	哈秀时尚网
meifashalong.com	中国美发沙龙网
cins.cn	胜思网络 
wshzg.com	万商汇
csx.cn	星沙论坛
weizhang.net	汽车违章记录查询
yxjob.net	深圳永信人才网
sojoline.com	双杰电气
huaao-trust.com	华澳信托
madajiefood.com	马大姐食品
dsbjq.com	电视背景墙
weizhang.net	汽车违章记录查询
ailipu.com	爱力浦
phpcms.name	好书推荐排行榜
ljhjgc.com	无锡邦瑞特金属制品有限公司
autob.cn	走吧网
3j3f.com	三警三匪杀人游戏网
meifashalong.com	中国美发沙龙网
cjyyjt.com	长江医药
jinchanwarp.com	浙江金蝉布艺股份有限公司
ok183.com	奇梦网
zhlm.com	整合联盟网
anngo.net	安购
cjyyjt.com	长江医药
jinchanwarp.com	浙江金蝉布艺股份有限公司
jjwxc.cn	晋江原创网
waihui321.com	今日外汇汇率查询
59na.com	59NA微信公众网
feiyoo.com	飞呀网
wenai.com	文爱 
kmtrh.org	　昆明同仁医院
lbgoo.com	乐百供采购网
gushi360.com	股市360股票网
51play.com	北京无限时空网络技术有限公司
zhlm.com	整合联盟网
chinaab.com	AB内衣
36yc.com	企业信息查询
xbd61.com	小布叮官网
888dmw.com	888动漫网
rizhaor.com	日照通
bjtvnews.com	华北新闻网
cnpension.net	中国养老金网
klxuexi.com	快乐学习教育官方网站
gdrsrc.com	广东人事人才培训网
fulinpm.com	富临精工
dp168.com	眉山东坡论坛
fulinpm.com	富临精工
sqjy.cn	宿迁市教育公共服务平台
fpstt.com	FPS游戏
autob.cn	走吧网
ahwhedu.com	五河教育网
ailipu.com	爱力浦
daq.cn	大Q科技官网
coodub.com	配音网
jz2007.com	聚招网
jxbsu.com	江西科技学院官方网站
dasuan110.com	大蒜价格网
qdguoyang.com	青岛国阳淘气堡
mcqyy.com	书村网 
kanunu.org	卡努努
789gg.com	789gg游戏网
tdwan.com	甜豆网
suibo.org	 随播播放器官方下载站
mud001.com	泥巴网络
keyvia.cn	凯发电气
hersp.com	好研
ccjt.net	虫虫吉他谱
kkapp.com	康佳电视社区
ins110.com	意时网
52shehua.com	奢华珠宝钻石网
cosunter.com	广生堂
efang.tv	易房网
hlj.net	黑龙江信息港
cosunter.com	广生堂
dasfjd.com	浙江迪安司法鉴定中心
12333.com	12333人才网
cnsyhz.com	三月中文 
10s1.com	中国-东盟矿产资源网
lulubei.com	撸撸杯官方网站
eyizhang.com	宜章新网
yile123.com	一乐电影网
shuiduok.com	水朵考资官网
kakazx.com	卡卡在线
myad.cn	脉动广告联盟
hnhw.com	河南户外网
kyhs.me	旷野呼声基督教网站
yanliang.com	阎良信息港 
cnpanyu.com	番禺网
gaitu.com	改图网 
0543bbs.com	滨州论坛
yile123.com	一乐电影网
shuiduok.com	水朵考资官网
yanliang.com	阎良信息港 
cnsyhz.com	三月中文 
myad.cn	脉动广告联盟
lulubei.com	撸撸杯官方网站
eyizhang.com	宜章新网
jjedu.com	江山教育信息网
cnpanyu.com	番禺网
meinv.cn	美女伊甸园
zcom.com	ZCOM电子杂志
indexedu.net	美梦网
51rrkank.com	51人人看电影网
xz-soft.com	兴竹信息
jjedu.com	江山教育信息网
ctntech.com	诚益通
ctntech.com	诚益通
0734.com	衡阳网
podvpn6.com	豆荚加速器
zbhbkj.com	中碧环保
haixunw.com	海讯中文网
wanba123.cn	玩吧
surveyfans.cn	亿达调查网
haishunpackaging.com	海顺新材
xz-soft.com	兴竹信息
zbhbkj.com	中碧环保
wh-aojie.com	奥杰科技
podvpn6.com	豆荚加速器
hengdrive.com	恒驱电机
13ejob.com	13亿人才网
efang.tv	易房网
ahwmw.cn	安徽文明网
uninf.com	优府网
0543bbs.com	滨州论坛
waihui321.com	今日外汇汇率查询
wanba123.cn	玩吧
chinaab.com	AB内衣
keyvia.cn	凯发电气
wh-aojie.com	奥杰科技
surveyfans.cn	亿达调查网
haishunpackaging.com	海顺新材
ljhjgc.com	无锡邦瑞特金属制品有限公司
uninf.com	优府网
becod.com	百酷网
mcts.cn	美辰旅游官方网站
edu63.com	教育路上网 
13ejob.com	13亿人才网
0760.com	中山视窗
banzhu.com	人人斑竹网
ss256.com	256网址大全 
xungou.net	训狗网
xtjita.com	 学弹吉他网
dongting.com	天天动听
yiaihu.cn	遗爱湖网
hdbird.com	飞鸟网游戏中心
gszs.cn	甘肃省高等院校招生办公室
gx118114.net	号码百事通
liwai.com	里外网
coolpad.cn	奇酷商城
dsbjq.com	电视背景墙
siluke.cc	思路客小说网
942mc.com	就是爱Mc网
lidroid.com	力卓官方网站
netpas.cc	 NETPAS 官网
cctxm.com	厦门康辉国际旅行社
wlxww.com	温岭新闻网
gongkaocn.com	卓博教育-公务员考试网
qilurencai.com	齐鲁人才网
commc.cn	共同管业
iyun.com	爱孕网 
ahwmw.cn	安徽文明网
my147.com	我的台球网
wuyangkeji.com	五洋科技
wuyangkeji.com	五洋科技
itmoo.com	艾牛电子书
elsyy.com	e良师益友网
hx365.net	海峡钓鱼网
beichende.com	北辰德
elsyy.com	e良师益友网
win9cn.com	Win10之家
ccradio.cn	长春广播网 
rise99.com	北京睿易思官网
chuangyebaba.com	创业爸爸
bieke.cc	鳖客网
jxedt.info	驾校一点通模拟考试
baiduyun.me	百度网盘论坛
sosowenwen.com	搜搜问问
hengdrive.com	恒驱电机
hftogo.com	合团网
yasn.com	雅森车品网
520319.cn	邢台热线
tmdwl.com	四川拓美达网络科技有限责任公司
dawawa.com	大娃娃游戏
zsmovies.com	舟山影城
9yz.com	第九驿站
aicbbs.com	中国红盾交流网
czxixigu.com	常州嬉戏谷官网
yc8.com	盛易数码科技
100kk.com	100kk小游戏
szjy.cc	深交同志
2213ys.com	2213养生网
bxbj168.com	深圳蚂蚁搬家公司 
xalyd.com	利雅得
diannaojishu.com	电脑技术
xkgxw.com	炫酷个性网
fangbaod.com	 浙江顺新防爆电器有限公司
awaker.org	觉醒家园
jiaosmtv.com	神马影院
taiyuge.com	台语歌曲网
ygtape.com	永冠股份
shenglongit.com	胜龙股份
diannaojishu.com	电脑技术
awaker.org	觉醒家园
jiaosmtv.com	神马影院
2213ys.com	2213养生网
aegisafe.com	翼捷股份
xalyd.com	利雅得
gellec.com	金力股份
0791abc.net	雷式教育
100kk.com	100kk小游戏
xkgxw.com	炫酷个性网
jhgl.cn	嘉华旅游
fangbaod.com	 浙江顺新防爆电器有限公司
szjy.cc	深交同志
zsmovies.com	舟山影城
shbaixing.cn	上海百姓信息网
taiyuge.com	台语歌曲网
ygtape.com	永冠股份
shenglongit.com	胜龙股份
wojubl.com	蜗居部落
tianji.com	天际网
scstock.com	中航证券
lnfzb.com	辽宁法治网
sosowenwen.com	搜搜问问
gellec.com	金力股份
lnfzb.com	辽宁法治网
ydjy.net	盐都教育网 
wanxia.com	晚霞老年网
junefield.com	庄胜
wojubl.com	蜗居部落
cc163.net	长春163网
khdyly.com	河南康辉国际旅行社
0791abc.net	雷式教育
uichange.com	天天锁屏
jkpj.com	健康普及网
wanyouxi.com	玩游戏网
ygjoy.com	阳光游戏平台
xbaodi.com	新宝坻网
daikan.cn	带看网
tianji.com	天际网
zhongguang.com	中光防雷
zhongguang.com	中光防雷
520love520.com	钟爱一生婚纱摄影
51sheyuan.com	摄苑网
1183114.com	发发黄页网
wzcn.cc	网址中国
xieege.com	邪恶哥
moneytu.com	钱途
ddsy.com	叮当快药
nanrenshang.com	男人尚
72r.net	完美女人世界网
4830.com	中国网址导航
xieege.com	邪恶哥
juiju.com	延庆生活门户
kinhoo.com	金鸿药业
hitevision-solution.com	鸿合智能
nanhuazaobao.net	南华早报网
beichende.com	北辰德
ddsy.com	叮当快药
nanrenshang.com	男人尚
lyshgs.com	升华感应
bxbj168.com	深圳蚂蚁搬家公司 
shumimi.com	书咪咪
ugou.cn	优歌网
haijizq.com	海际证券
1183114.com	发发黄页网
jpkoo.com	街拍客
jxedt.info	驾校一点通模拟考试
chuangyebaba.com	创业爸爸
tmdwl.com	四川拓美达网络科技有限责任公司
qbiao.cn	齐表网
ydjy.net	盐都教育网 
commc.cn	共同管业
wkek.net	免费VPN推荐 
bwoer.com	被窝儿
cc163.net	长春163网
51sheyuan.com	摄苑网
lawen2.org	辣文小说网
jkpj.com	健康普及网
datang5.com	大唐生活网
moneytu.com	钱途
xtjita.com	 学弹吉他网
cqrsksw.com	重庆人事考试网
qianfan.net	千帆育儿网 
4830.com	中国网址导航
czxixigu.com	常州嬉戏谷官网
khdyly.com	河南康辉国际旅行社
jsconnect.com	科耐特
ugou.cn	优歌网
78baby.com	趣吧贝贝
2g.cn	2G游戏
iweimeijuzi.com	唯美句
kukushu.com	 酷酷书屋
wanggongwang.com	网供网
wkek.net	免费VPN推荐 
baigle.com	百狗搜索引擎
xlyouxi.com	迅雷游戏官网
gamedashi.com	游戏大师官网
jpkoo.com	街拍客
lolkeng.com	小坑网
shinzoom.com	星城石墨
qbiao.cn	齐表网
0755car.com	车神榜
bszsks.com	百色招生考试
exceedconn.com	丰年科技
bhxx.net	绍兴市北海小学教育集团
macrosilicon.com	宏晶科技
aegisafe.com	翼捷股份
zhaoshang01.com	招商第一网
frjy.cn	费尔教育
daydaytest.com	对对塔
aiwaimai.com	爱外卖网
u581.com	u581网址大全
lululu.com	噜噜噜 
kbcool.com	昆山论坛
banyungong.net	搬运工
nadc.cn	海投网
daydaytest.com	对对塔
u581.com	u581网址大全
shinzoom.com	星城石墨
lululu.com	噜噜噜 
cyvalve.com	长仪股份
doohe.com	东和股份
kbcool.com	昆山论坛
ahcme.cn	安徽机电职业技术学院
macrosilicon.com	宏晶科技
043218.cn	吉林市招聘网
hftogo.com	合团网
siluke.cc	思路客小说网
banyungong.net	搬运工
bszsks.com	百色招生考试
aiwaimai.com	爱外卖网
nj91.com	南京就业网
942mc.com	就是爱Mc网
dasuan110.com	大蒜价格网
nadc.cn	海投网
nextvip.cn	国家职业资格考试网
gougouxs.com	狗狗书籍
cqrsksw.com	重庆人事考试网
datang5.com	大唐生活网
guuoo.com	谷网
gougouxs.com	狗狗书籍
ip66.com	成都艾普宽带网上营业厅
ejiawang.cc	亿家装修网
01w.com	第一门户
stuhome.net	学生之家
jsconnect.com	科耐特
yaanren.net	雅安人网
kinhoo.com	金鸿药业
chinayes.com	YES娱乐
nj91.com	南京就业网
appifan.com	appifan
aizhixing.net	爱之星
doohe.com	东和股份
zixijiaoshi.com	自习教室
21gold.org	中国贵金属投资网
055114.com	大明网
baoxiu.com	中国保修网
sifanghua.cn	女人私房话
iyanglei.cn	电脑配置网
adamerck.net	奥默医药
kingsunedu.com	方直科技
kukushu.com	 酷酷书屋
innovane.com	祥云信息
hdsjkg.com	祥瑞丰
adamerck.net	奥默医药
jantech.cn	捷安高科
bianjibu.net	杂志网
055114.com	大明网
54qj.com	奇骥官方网站
iyanglei.cn	电脑配置网
exceedconn.com	丰年科技
ttongda.com	西安同大
hmjyj.cn	滨州市惠民县教育信息网
icaijing.com	爱财经网
sifanghua.cn	女人私房话
hnhuanglong.com	皇隆制药
hehehehehe.cn	呵呵呵呵呵
jantech.cn	捷安高科
lg918.cn	湖北老鬼鱼饵有限责任公司
qianfan.net	千帆育儿网 
icaijing.com	爱财经网
ahcme.cn	安徽机电职业技术学院
cyvalve.com	长仪股份
luqq.net	集Q网
97665.com	97665手机游戏门户
klyou.com	快乐游
luyitong.com	鲁亿通
luyitong.com	鲁亿通
0757house.com	顺德新房网
zzuren.net	郑州大学论坛
innovane.com	祥云信息
hbjxad.com	金旭农发
xineee.com	新一网
wuhexxg.com	五河信息港
reach-ad.com	瑞诚股份
juiju.com	延庆生活门户
jhgl.cn	嘉华旅游
8090st.com	8090st
aizongyi.com	爱综艺
hnhuanglong.com	皇隆制药
gogo.com	联易互动
huole.com	火了音乐
hmjyj.cn	滨州市惠民县教育信息网
henhenzhuan.com	狠狠转
casualshoe.cn	crocs官方商城
eastunion.net	东联科技
5elady.com	唯伊女性网
bianjibu.net	杂志网
bxdoor.com	百姓生活早班车 
guiju.cc	桂居网
zhufukc.com	主妇快餐
casualshoe.cn	crocs官方商城
5elady.com	唯伊女性网
shichuedu.com	师出教育
aizhixing.net	爱之星
huole.com	火了音乐
eastunion.net	东联科技
reach-ad.com	瑞诚股份
3m6.net	姓名测试网
pifusuo.com	南京皮肤病研究所
ejiawang.cc	亿家装修网
jzptt.com	锦州在线
haokan123.biz	好看123网址导航
wanggongwang.com	网供网
zzuren.net	郑州大学论坛
henhenzhuan.com	狠狠转
yshshuimitao.com	无锡阳山玫瑰水蜜桃园
cn-talent.net	天利和
hbjxad.com	金旭农发
zhufukc.com	主妇快餐
p7game.com	派趣科技
fabu8.cn	发布吧
shbaixing.cn	上海百姓信息网
hi772.com	来宾生活网
jzptt.com	锦州在线
shichuedu.com	师出教育
xyiso.com	新壹搜
3m6.net	姓名测试网
guiju.cc	桂居网
hsx99.com	临沂化绍新钓鱼用品有限公司
haijizq.com	海际证券
hitevision-solution.com	鸿合智能
54qj.com	奇骥官方网站
qdao.cn	青大在线 
df818.com	登封818 
245600.com	祁门人网
043218.cn	吉林市招聘网
320921.com	响水论坛
diaoyy.com	钓友钓鱼网
0794.org	新抚
pifusuo.com	南京皮肤病研究所
zhongtaihangzhou.com	中泰股份
zhongtaihangzhou.com	中泰股份
lyshgs.com	升华感应
7suoluo.com	索罗学院
chiping.org	茌平信息港
yshshuimitao.com	无锡阳山玫瑰水蜜桃园
hbsfdx.com	淮北师范大学校园网
shumimi.com	书咪咪
haokan123.biz	好看123网址导航
doomii.com	豆麦网
163yesok.com	163播客网
zapya.cn	快拿
591film.com	福州电影院网
lawen2.org	辣文小说网
97yjs.com	97考研网
bwoer.com	被窝儿
curainvest.cn	中城投资
ttongda.com	西安同大
365bh.cn	滨海生活网
ladyhua.com	女人花
dpkyz.com	东圃汽车客运站官网
dianyingla.com	电影啦
chunyuezuche.com	上海春越汽车租赁有限公司
qreader.me	快读官方网站
at317.com	保险知识网
at317.com	保险知识网
dpkyz.com	东圃汽车客运站官网
chunyuezuche.com	上海春越汽车租赁有限公司
push-herbchem.com	普思生物
dianyingla.com	电影啦
qreader.me	快读官方网站
365bh.cn	滨海生活网
gecpc.com	中控智联
curainvest.cn	中城投资
ykj123.com	虹达机械
psr-china.com	力源环保
hongshen.net	红神网
ykj123.com	虹达机械
psr-china.com	力源环保
gecpc.com	中控智联
hongshen.net	红神网
push-herbchem.com	普思生物
lining.com	李宁官方网站
55.cc	哇哇女性网
haotui.com	好推网
w.cn	w.cn
pf178.com	品众批发网
loorin.com	烙印网
lady361.com	361女性网 
zhiboche.com	体育直播车
xiadu.com	夏都网
jtjc.cn	交管信息网
ourseo.net	众优网
g1080.com	gtv游戏网
lovingjob.com	爱兼职网
essh.cn	易事生活网
zn8.com	智能吧
gudi.cc	古谛国际有限公司 
neihantu.cc	内涵图吧
pingdu163.com	平度生活网
job1688.com	川聘英才网
38junpf.com	北京市燕都医院
shuo6.com	说乐社区
51jingmen.com	51荆门网
qiny.cn	青柠情侣商城
i0514.cn	小艾生活网
hzgzn.com	杭州硅藻泥
jxuu.cn	优优网
geyuce.com	哥预测
hzshw.com	菏泽生活网
mercachina.com	西班牙华人门户
53ee.com	53EE分类目录
hjyc.com	黄金药场
simei8.com	丝美吧
17try.cn	试尚网 
tongbai8.com	桐柏网
haoejia.com	好易网视
pingdu163.com	平度生活网
job1688.com	川聘英才网
gudi.cc	古谛国际有限公司 
38junpf.com	北京市燕都医院
ymjinrong.com	一米金融网
shuo6.com	说乐社区
neihantu.cc	内涵图吧
51jingmen.com	51荆门网
qiny.cn	青柠情侣商城
i0514.cn	小艾生活网
hzgzn.com	杭州硅藻泥
jxuu.cn	优优网
geyuce.com	哥预测
hzshw.com	菏泽生活网
mercachina.com	西班牙华人门户
53ee.com	53EE分类目录
simei8.com	丝美吧
ctmcq.com	朝天门火锅
17try.cn	试尚网 
tongbai8.com	桐柏网
haoejia.com	好易网视
hjyc.com	黄金药场
63pet.com	63宠文网
3608.com	全游网
yuesaoba.cn	月嫂吧
wangdaiclub.com	网贷俱乐部
yc38.com	扬成网
himovie.com	嗨电影网_
yyyyba.com	YY音乐吧
np28.com	牛棚文学 
wqdao.com	玩Q岛
ezeem.com	e京网
togoo.com	TOGOO途购网
aituwo.com	余额查询网
starandroid.com	安卓星空
qq3366.net	全球商务网
d399.com	qq分组大全
shu4.net	书室
xintaishequ.com	新泰社区
qingren.tv	情人电影网
mytianhe.com	我的天河社区
qx818.cn	魃铰厶
yuesaoba.cn	月嫂吧
63pet.com	63宠文网
wangdaiclub.com	网贷俱乐部
yc38.com	扬成网
3608.com	全游网
himovie.com	嗨电影网_
yyyyba.com	YY音乐吧
np28.com	牛棚文学 
chunwanwu.com	春晚屋
wqdao.com	玩Q岛
ezeem.com	e京网
togoo.com	TOGOO途购网
luqq.net	集Q网
aituwo.com	余额查询网
d399.com	qq分组大全
shu4.net	书室
xintaishequ.com	新泰社区
qingren.tv	情人电影网
mytianhe.com	我的天河社区
qx818.cn	魃铰厶
starandroid.com	安卓星空
qq3366.net	全球商务网
longmeicn.com	龙媒网 
ymjinrong.com	一米金融网
993ye.com	乐喵相声小品网
luxiangba.cn	体育吧
chunwanwu.com	春晚屋
puercha.cc	云南普洱茶网 
hudou.com	 胡豆网
11x5w.com	11选5网
janezhang.com	张靓颖官方网站
ctmcq.com	朝天门火锅
youmtu.com	优美图片网
hzhy163.com	华艺股份
yjba.net	阳江吧
jiajiao-edu.com	易得优
proxycn.cn	代理中国
showku.com	秀酷在线
tvyugao.com	 电视预告网
kingsunedu.com	方直科技
xudan123.com	飞Q官方网站
cn-talent.net	天利和
wodubao.com	我读报
ladyw.net	女人屋女性网
renzy.cn	秀是一种习惯
qqran.com	Q友头像
haniu360.com	哈牛网上商城
hdsjkg.com	祥瑞丰
nx.cn	宁夏网虫
byfen.net	百分网
bf199.com	比分199
zcpc.net	海N药业
yongpingziyuan.com	永平资源
wenqun.hk	文群网络
xh-arch.com	兴华设计
ukin-tech.com	优景科技
fraeco.com	丰荣航空
crpc.co	中润油
sailing-china.cn	新立科技
etkj.cn	毅通股份
hitqs.com	强石股份
wxjava.com	集华股份
ukin-tech.com	优景科技
sailing-china.cn	新立科技
etkj.cn	毅通股份
wxjava.com	集华股份
zcpc.net	海N药业
hitqs.com	强石股份
crpc.co	中润油
yongpingziyuan.com	永平资源
fraeco.com	丰荣航空
hljwmcx.com	五米常香
gcomtechnology.com	广脉科技
sairongxin.com	赛融信
zfsysz.com	兆方石油
jxsenyang.com	森阳科技
nongkaigufen.com	农凯股份
fjlstz.net	联圣发展
soundnybio.com	盛齐安
soundnybio.com	盛齐安
sairongxin.com	赛融信
nongkaigufen.com	农凯股份
hljwmcx.com	五米常香
fjlstz.net	联圣发展
zfsysz.com	兆方石油
jxsenyang.com	森阳科技
gcomtechnology.com	广脉科技
yzxbsz.net	欣宝科技
yzxbsz.net	欣宝科技
wenqun.hk	文群网络
hzhy163.com	华艺股份
xh-arch.com	兴华设计
838413.com	易名科技
exc-resin.com	金森源
exc-resin.com	金森源
838413.com	易名科技
