撼地者	Earthshaker	攻击类型：近战|定位：辅助-先手-控制-高爆发-|阵营：天辉|其他简称：小牛，牛，神牛，撼地神牛	沟壑|强化图腾|余震|回音击
斯温	Sven	攻击类型：近战|定位：核心-控制-先手-耐久-高爆发-|阵营：天辉|其他简称：SV，流浪	风暴之拳|巨力挥舞|战吼|神之力量
小小	Tiny	攻击类型：近战|定位：核心-高爆发-推进-先手-耐久-控制-|阵营：天辉|其他简称：山岭	山崩|投掷|抓树|长大|投掷树木
昆卡	Kunkka	攻击类型：近战|定位：核心-控制-先手-耐久-高爆发-|阵营：天辉|其他简称：船长	洪流|潮汐使者|X标记|幽灵船|送回
兽王	Beastmaster	攻击类型：近战|定位：先手-控制-耐久-高爆发-|阵营：天辉|其他简称：BM	野性之斧|野性呼唤|野性之心|原始咆哮
龙骑士	Dragon Knight	攻击类型：近战|定位：核心-推进-耐久-控制-先手-高爆发-|阵营：天辉|其他简称：龙骑，DK	火焰气息|神龙摆尾|龙族血统|古龙形态
发条技师	Rattletrap	攻击类型：近战|定位：先手-控制-耐久-高爆发-|阵营：天辉|其他简称：发条、CG	弹幕冲击|能量齿轮|照明火箭|发射钩爪
全能骑士	Omniknight	攻击类型：近战|定位：辅助-耐久-高爆发-|阵营：天辉|其他简称：全能	洗礼|驱逐|退化光环|守护天使
哈斯卡	Huskar	攻击类型：远程|定位：核心-耐久-先手-|阵营：天辉|其他简称：神灵、神灵武士	活血术|沸血之矛|狂战士之血|牺牲
炼金术士	Alchemist	攻击类型：近战|定位：核心-辅助-耐久-控制-先手-高爆发-|阵营：天辉|其他简称：炼金	酸性喷雾|不稳定化合物|贪魔的贪婪|化学狂暴|投掷不稳定化合物
酒仙	Brewmaster	攻击类型：近战|定位：核心-先手-耐久-控制-高爆发-|阵营：天辉|其他简称：熊猫	雷霆一击|醉酒云雾|醉拳|元素分离
树精卫士	Treant	攻击类型：近战|定位：辅助-先手-耐久-控制-逃生-|阵营：天辉|其他简称：大树	自然蔽护|寄生种子|活体护甲|丛林之眼|疯狂生长
艾欧	Wisp	攻击类型：远程|定位：辅助-逃生-高爆发-|阵营：天辉|其他简称：小精灵	羁绊|幽魂|过载|拉近幽魂|拉远幽魂|降临|断开连接
半人马战行者	Centaur	攻击类型：近战|定位：耐久-先手-控制-高爆发-逃生-|阵营：天辉|其他简称：人马	马蹄践踏|双刃剑|反击|奔袭冲撞
伐木机	Shredder	攻击类型：近战|定位：高爆发-耐久-逃生-|阵营：天辉|其他简称：地精撕裂者	死亡旋风|伐木锯链|活性护甲|锯齿飞轮|锯齿飞轮|收回锯齿飞轮|收回锯齿飞轮
钢背兽	Bristleback	攻击类型：近战|定位：核心-耐久-先手-高爆发-|阵营：天辉|其他简称：钢背，背背猪	粘稠鼻液|刺针扫射|钢毛后背|战意
巨牙海民	Tusk	攻击类型：近战|定位：先手-控制-高爆发-|阵营：天辉|其他简称：海民	寒冰碎片|雪球|冰封魔印|海象飞踢|海象神拳！|雪球滚滚
上古巨神	Elder Titan	攻击类型：近战|定位：先手-控制-高爆发-耐久-|阵营：天辉|其他简称：大牛	回音重踏|星体游魂|自然秩序|裂地沟壑|星体游魂回归
军团指挥官	Legion Commander	攻击类型：近战|定位：核心-控制-先手-耐久-高爆发-|阵营：天辉|其他简称：军团	压倒性优势|强攻|勇气之霎|决斗
大地之灵	Earth Spirit	攻击类型：近战|定位：高爆发-逃生-控制-先手-耐久-|阵营：天辉|其他简称：土熊猫	巨石冲击|巨石翻滚|地磁之握|残岩|残岩魔咒|磁化
凤凰	Phoenix	攻击类型：远程|定位：辅助-高爆发-先手-逃生-控制-|阵营：天辉|其他简称：凤凰	凤凰冲击|烈火精灵|烈日炙烤|切换移动状态|超新星|发动烈火精灵|终止凤凰冲击|终止烈日炙烤
敌法师	Antimage	攻击类型：近战|定位：核心-逃生-高爆发-|阵营：天辉|其他简称：AM、敌法	法力损毁|闪烁|法术护盾|法力虚空
卓尔游侠	Drow Ranger	攻击类型：远程|定位：核心-控制-推进-|阵营：天辉|其他简称：小黑、崔希丝	霜冻之箭|狂风|精准光环|射手天赋
主宰	Juggernaut	攻击类型：近战|定位：核心-推进-逃生-|阵营：天辉|其他简称：剑圣	剑刃风暴|治疗守卫|剑舞|无敌斩
米拉娜	Mirana	攻击类型：远程|定位：核心-辅助-逃生-高爆发-控制-|阵营：天辉|其他简称：白虎，虎妞，月女	群星风暴|月神之箭|跳跃|月之暗面
变体精灵	Morphling	攻击类型：远程|定位：核心-逃生-耐久-高爆发-控制-|阵营：天辉|其他简称：水人	波浪形态|变体攻击（敏捷）|变体攻击（力量）|属性变换（敏捷获取）|属性变换（力量获取）|变形|替换复制品
幻影长矛手	Phantom Lancer	攻击类型：近战|定位：核心-逃生-推进-高爆发-|阵营：天辉|其他简称：猴子、阿兹瑞斯	灵魂之矛|神行百变|幻影冲锋|并列
复仇之魂	Vengefulspirit	攻击类型：远程|定位：辅助-先手-控制-高爆发-逃生-|阵营：天辉|其他简称：VS、仙德尔莎?丝木	魔法箭|恐怖波动|复仇光环|移形换位
力丸	Riki	攻击类型：近战|定位：核心-逃生-控制-|阵营：天辉|其他简称：隐刺	烟幕|闪烁突袭|刀光谍影|绝杀秘技
狙击手	Sniper	攻击类型：远程|定位：核心-高爆发-|阵营：天辉|其他简称：火枪，传说哥	榴霰弹|爆头|瞄准|暗杀
圣堂刺客	Templar Assassin	攻击类型：远程|定位：核心-逃生-|阵营：天辉|其他简称：TA，圣堂	折光|隐匿|灵能之刃|触发陷阱|灵能陷阱
露娜	Luna	攻击类型：远程|定位：核心-高爆发-推进-|阵营：天辉|其他简称：月骑	月光|月刃|月之祝福|月蚀
赏金猎人	Bounty Hunter	攻击类型：近战|定位：逃生-高爆发-|阵营：天辉|其他简称：赏金,BH	投掷飞镖|忍术|暗影步|追踪术
熊战士	Ursa	攻击类型：近战|定位：核心-打野-耐久-控制-|阵营：天辉|其他简称：拍拍熊	震撼大地|超强力量|怒意狂击|激怒
矮人直升机	Gyrocopter	攻击类型：远程|定位：核心-高爆发-控制-|阵营：天辉|其他简称：飞机	火箭弹幕|追踪导弹|高射火炮|召唤飞弹
德鲁伊	Lone Druid	攻击类型：远程|定位：核心-推进-打野-耐久-|阵营：天辉|其他简称：LD、熊德、DLY、小德	熊灵伙伴|狂猛|野蛮咆哮|战斗嚎叫|变形术|人形态
娜迦海妖	Naga Siren	攻击类型：近战|定位：核心-辅助-推进-控制-先手-逃生-|阵营：夜魇|其他简称：小娜迦	镜像|诱捕|激流|海妖之歌|终止海妖之歌
巨魔战将	Troll Warlord	攻击类型：远程|定位：核心-推进-控制-耐久-|阵营：天辉|其他简称：巨魔	狂战士之怒|旋风飞斧（远程）|旋风飞斧（近战）|热血战魂|战斗专注
灰烬之灵	Ember Spirit	攻击类型：近战|定位：核心-逃生-高爆发-控制-先手-|阵营：天辉|其他简称：火猫	炎阳索|无影拳|烈火罩|激活残焰|残焰
齐天大圣	Monkey King	攻击类型：近战|定位：核心-逃生-控制-先手-|阵营：天辉|其他简称：大圣、猴子	棒击大地|丛林之舞|乾坤之跃|如意棒法|七十二变|猴子猴孙|变回原状
石鳞剑士	Pangolier	攻击类型：近战|定位：核心-高爆发-控制-耐久-逃生-先手-|阵营：天辉|其他简称：穿山甲	虚张声势|甲盾冲击|一剑穿心|地雷滚滚|停止滚动
水晶室女	Crystal Maiden	攻击类型：远程|定位：辅助-控制-高爆发-打野-|阵营：天辉|其他简称：冰女	冰霜新星|冰封禁制|奥术光环|极寒领域
帕克	Puck	攻击类型：远程|定位：先手-控制-逃生-高爆发-|阵营：天辉|其他简称：puck，精灵龙	幻象法球|新月之痕|相位转移|灵动之翼|梦境缠绕
风暴之灵	Storm Spirit	攻击类型：远程|定位：核心-逃生-高爆发-先手-控制-|阵营：天辉|其他简称：蓝猫	残影|电子涡流|超负荷|球状闪电
风行者	Windrunner	攻击类型：远程|定位：核心-辅助-控制-逃生-高爆发-|阵营：天辉|其他简称：风行，WR	束缚击|强力击|风行|集中火力
宙斯	Zeus	攻击类型：远程|定位：高爆发-|阵营：天辉|其他简称：神王	弧形闪电|雷击|静电场|雷云|雷神之怒
莉娜	Lina	攻击类型：远程|定位：辅助-核心-高爆发-控制-|阵营：天辉|其他简称：火女	龙破斩|光击阵|炽魂|神灭斩
暗影萨满	Shadow Shaman	攻击类型：远程|定位：辅助-推进-控制-高爆发-先手-|阵营：天辉|其他简称：小Y	苍穹震击|妖术|枷锁|群蛇守卫
修补匠	Tinker	攻击类型：远程|定位：核心-高爆发-推进-|阵营：天辉|其他简称：TK	激光|热导飞弹|进击的机械|再装填
先知	Furion	攻击类型：远程|定位：核心-打野-推进-逃生-高爆发-|阵营：天辉|其他简称：FUR	发芽|传送|自然的呼唤|自然之怒
魅惑魔女	Enchantress	攻击类型：远程|定位：辅助-打野-推进-耐久-控制-|阵营：天辉|其他简称：小鹿	不可侵犯|魅惑|自然之助|推进
杰奇洛	Jakiro	攻击类型：远程|定位：辅助-高爆发-推进-控制-|阵营：天辉|其他简称：双头龙	冰火交加|冰封路径|液态火|烈焰焚身
陈	Chen	攻击类型：远程|定位：辅助-打野-推进-|阵营：天辉|其他简称：Chen	赎罪|忠诚考验|神圣劝化|上帝之手
沉默术士	Silencer	攻击类型：远程|定位：核心-辅助-控制-先手-高爆发-|阵营：天辉|其他简称：沉默、诺崇	奥术诅咒|智慧之刃|最后遗言|全领域静默
食人魔魔法师	Ogre Magi	攻击类型：近战|定位：辅助-高爆发-控制-耐久-先手-|阵营：天辉|其他简称：蓝胖子	火焰爆轰|引燃|嗜血术|未精通的火焰爆轰|多重施法
拉比克	Rubick	攻击类型：远程|定位：辅助-控制-高爆发-|阵营：天辉|其他简称：GM	隔空取物|弱化能流|失效力场|窃取的魔法|窃取的魔法|技能窃取|隔空取物着陆|||
干扰者	Disruptor	攻击类型：远程|定位：辅助-控制-高爆发-先手-|阵营：天辉|其他简称：萨尔	雷霆之击|恶念瞥视|动能力场|静态风暴
光之守卫	Keeper Of The Light	攻击类型：远程|定位：辅助-高爆发-控制-打野-|阵营：天辉|其他简称：光法、伊扎洛	冲击波|法力流失|查克拉魔法|召回|致盲之光|灵魂形态|释放冲击波|冲击波|释放冲击波
天怒法师	Skywrath Mage	攻击类型：远程|定位：辅助-高爆发-控制-|阵营：天辉|其他简称：龙鹰	奥法鹰隼|震荡光弹|上古封印|神秘之耀
神谕者	Oracle	攻击类型：远程|定位：辅助-高爆发-控制-逃生-|阵营：天辉|其他简称：神谕者、Oracle	气运之末|命运敕令|涤罪之焰|虚妄之诺
工程师	Techies	攻击类型：远程|定位：高爆发-控制-|阵营：天辉|其他简称：炸弹人、拉登	感应地雷|静滞陷阱|爆破起飞！|集中引爆|雷区标识|遥控炸弹
邪影芳灵	Dark Willow	攻击类型：远程|定位：辅助-高爆发-控制-逃生-|阵营：天辉|其他简称：	荆棘迷宫|暗影之境|诅咒王冠|作祟|恐吓
斧王	Axe	攻击类型：近战|定位：先手-耐久-控制-打野-|阵营：夜魇|其他简称：蒙哥可汗、Mogul Khan、Axe	狂战士之吼|战斗饥渴|反击螺旋|淘汰之刃
帕吉	Pudge	攻击类型：近战|定位：控制-先手-耐久-高爆发-|阵营：夜魇|其他简称：屠夫，胖子	肉钩|腐烂|腐肉堆积|肢解
沙王	Sand King	攻击类型：近战|定位：先手-控制-高爆发-逃生-打野-|阵营：夜魇|其他简称：SK	掘地穿刺|沙尘暴|腐尸毒|地震
斯拉达	Slardar	攻击类型：近战|定位：核心-耐久-先手-控制-逃生-|阵营：夜魇|其他简称：大鱼人	守卫冲刺|鱼人碎击|深海重击|侵蚀雾霭
潮汐猎人	Tidehunter	攻击类型：近战|定位：先手-耐久-控制-高爆发-|阵营：夜魇|其他简称：潮汐、TH	巨浪|海妖外壳|锚击|毁灭
冥魂大帝	Skeleton King	攻击类型：近战|定位：核心-辅助-耐久-控制-先手-|阵营：夜魇|其他简称：SNK、骷髅王	冥火爆击|吸血光环|殊死一搏|重生
噬魂鬼	Life Stealer	攻击类型：近战|定位：核心-耐久-打野-逃生-控制-|阵营：夜魇|其他简称：小狗	狂暴|盛宴|撕裂伤口|吸收|感染|控制|吞噬|喷吐
暗夜魔王	Night Stalker	攻击类型：近战|定位：核心-先手-耐久-控制-高爆发-|阵营：夜魇|其他简称：夜魔	虚空|伤残恐惧|暗夜猎影|黑暗时间
末日使者	Doom Bringer	攻击类型：近战|定位：核心-控制-先手-耐久-高爆发-|阵营：夜魇|其他简称：末日，爸爸	吞噬|焦土|阎刃|技能（来自吞噬）|技能（来自吞噬）|末日
裂魂人	Spirit Breaker	攻击类型：近战|定位：核心-先手-控制-耐久-逃生-|阵营：夜魇|其他简称：白牛，SB	暗影冲刺|神行太保|巨力重击|幽冥一击
狼人	Lycan	攻击类型：近战|定位：核心-推进-打野-耐久-逃生-|阵营：夜魇|其他简称：Lyc	召狼|嗥叫|野性驱使|变身
混沌骑士	Chaos Knight	攻击类型：近战|定位：核心-控制-耐久-推进-先手-|阵营：夜魇|其他简称：混沌	混乱之箭|实相裂隙|混沌一击|混沌之军
不朽尸王	Undying	攻击类型：近战|定位：辅助-耐久-控制-高爆发-|阵营：夜魇|其他简称：尸王	腐朽|噬魂|墓碑|血肉傀儡
马格纳斯	Magnataur	攻击类型：近战|定位：先手-控制-高爆发-逃生-|阵营：夜魇|其他简称：猛犸	震荡波|授予力量|巨角冲撞|两极反转
亚巴顿	Abaddon	攻击类型：近战|定位：辅助-核心-耐久-|阵营：夜魇|其他简称：死骑	迷雾缠绕|无光之盾|魔霭诅咒|回光返照
孽主	Abyssal Underlord	攻击类型：近战|定位：辅助-高爆发-控制-耐久-逃生-|阵营：夜魇|其他简称：	火焰风暴|怨念深渊|衰退光环|黑暗之门|取消黑暗之门
嗜血狂魔	Bloodseeker	攻击类型：近战|定位：核心-控制-打野-高爆发-先手-|阵营：夜魇|其他简称：BS	血之狂暴|血之祭祀|嗜血渴望|割裂
影魔	Nevermore	攻击类型：远程|定位：核心-高爆发-|阵营：夜魇|其他简称：SF	毁灭阴影|毁灭阴影|毁灭阴影|支配死灵|魔王降临|魂之挽歌
剃刀	Razor	攻击类型：远程|定位：核心-耐久-高爆发-推进-|阵营：夜魇|其他简称：电棍	等离子场|静电连接|不稳定电流|风暴之眼
剧毒术士	Venomancer	攻击类型：远程|定位：辅助-高爆发-先手-推进-控制-|阵营：夜魇|其他简称：剧毒	瘴气|毒刺|瘟疫守卫|剧毒新星
虚空假面	Faceless Void	攻击类型：近战|定位：核心-先手-控制-逃生-耐久-|阵营：夜魇|其他简称：虚空	时间漫游|时间膨胀|时间锁定|时间结界
幻影刺客	Phantom Assassin	攻击类型：近战|定位：核心-逃生-|阵营：夜魇|其他简称：PA、幻刺、魅影之纱	窒息之刃|幻影突袭|模糊|恩赐解脱
冥界亚龙	Viper	攻击类型：远程|定位：核心-耐久-先手-控制-|阵营：夜魇|其他简称：VIP，毒龙	毒性攻击|幽冥剧毒|腐蚀皮肤|蝮蛇突袭
克林克兹	Clinkz	攻击类型：远程|定位：核心-逃生-推进-|阵营：夜魇|其他简称：骨弓	扫射|灼热之箭|骨隐步|死亡契约
育母蜘蛛	Broodmother	攻击类型：近战|定位：核心-推进-逃生-高爆发-|阵营：夜魇|其他简称：蜘蛛	孵化蜘蛛|织网|麻痹之咬|极度饥渴
编织者	Weaver	攻击类型：远程|定位：核心-逃生-|阵营：夜魇|其他简称：蚂蚁	虫群|缩地|连击|时光倒流
幽鬼	Spectre	攻击类型：近战|定位：核心-耐久-逃生-|阵营：夜魇|其他简称：Spe	幽鬼之刃|荒芜|折射|空降|鬼影重重
米波	Meepo	攻击类型：近战|定位：核心-逃生-高爆发-控制-先手-推进-|阵营：夜魇|其他简称：地卜	地之束缚|忽悠|地之突袭|分则能成
司夜刺客	Nyx Assassin	攻击类型：近战|定位：控制-高爆发-先手-逃生-|阵营：夜魇|其他简称：NA，小强	穿刺|法力燃烧|尖刺外壳|钻地|复仇|现身
斯拉克	Slark	攻击类型：近战|定位：核心-逃生-控制-高爆发-|阵营：夜魇|其他简称：小鱼人	黑暗契约|突袭|能量转移|暗影之舞
美杜莎	Medusa	攻击类型：远程|定位：核心-控制-耐久-|阵营：夜魇|其他简称：1姐	分裂箭|秘术异蛇|魔法护盾|石化凝视
恐怖利刃	Terrorblade	攻击类型：近战|定位：核心-推进-高爆发-|阵营：夜魇|其他简称：TB、魂守	倒影|惑幻|魔化|魂断
天穹守望者	Arc Warden	攻击类型：远程|定位：核心-逃生-高爆发-|阵营：夜魇|其他简称：弧光守望者、电狗	乱流|磁场|闪光幽魂|风暴双雄
祸乱之源	Bane	攻击类型：远程|定位：辅助-控制-高爆发-耐久-|阵营：夜魇|其他简称：痛苦之源	虚弱|蚀脑|噩梦|魔爪|噩梦终止
巫妖	Lich	攻击类型：远程|定位：辅助-高爆发-|阵营：夜魇|其他简称：LICH	寒霜爆发|霜冻护甲|献祭|连环霜冻
莱恩	Lion	攻击类型：远程|定位：辅助-控制-高爆发-先手-|阵营：夜魇|其他简称：Lion	裂地尖刺|妖术|法力吸取|死亡之指
巫医	Witch Doctor	攻击类型：远程|定位：辅助-高爆发-控制-|阵营：夜魇|其他简称：WD	麻痹药剂|巫毒回复术|诅咒|死亡守卫
谜团	Enigma	攻击类型：远程|定位：控制-打野-先手-推进-|阵营：夜魇|其他简称：Enig	憎恶|恶魔转化|午夜凋零|黑洞
瘟疫法师	Necrolyte	攻击类型：远程|定位：核心-高爆发-耐久-控制-|阵营：夜魇|其他简称：NEC，死灵法	死亡脉冲|幽魂护罩|竭心光环|死神镰刀
术士	Warlock	攻击类型：远程|定位：辅助-先手-控制-|阵营：夜魇|其他简称：Warlock	致命连接|暗言术|剧变|混乱之祭
痛苦女王	Queenofpain	攻击类型：远程|定位：核心-高爆发-逃生-|阵营：夜魇|其他简称：QOP	暗影突袭|闪烁|痛苦尖叫|超声冲击波
死亡先知	Death Prophet	攻击类型：远程|定位：核心-推进-高爆发-控制-|阵营：夜魇|其他简称：DP	地穴虫群|沉默魔法|吸魂巫术|驱使恶灵
帕格纳	Pugna	攻击类型：远程|定位：高爆发-推进-|阵营：夜魇|其他简称：骨法	幽冥爆轰|衰老|幽冥守卫|生命汲取
戴泽	Dazzle	攻击类型：远程|定位：辅助-高爆发-控制-|阵营：夜魇|其他简称：暗牧	剧毒之触|薄葬|暗影波|编织
拉席克	Leshrac	攻击类型：远程|定位：核心-辅助-高爆发-推进-控制-|阵营：夜魇|其他简称：老鹿，光鹿	撕裂大地|恶魔敕令|闪电风暴|脉冲新星
黑暗贤者	Dark Seer	攻击类型：近战|定位：先手-打野-逃生-控制-|阵营：夜魇|其他简称：兔子、黑贤、DS	真空|离子外壳|奔腾|复制之墙
蝙蝠骑士	Batrider	攻击类型：远程|定位：先手-打野-控制-逃生-|阵营：夜魇|其他简称：蝙蝠	粘性燃油|烈焰破击|火焰飞行|燃烧枷锁
远古冰魄	Ancient Apparition	攻击类型：远程|定位：辅助-控制-高爆发-|阵营：夜魇|其他简称：冰魂	寒霜之足|冰霜漩涡|极寒之触|冰晶爆轰|释放
祈求者	Invoker	攻击类型：远程|定位：核心-高爆发-控制-逃生-推进-|阵营：夜魇|其他简称：卡尔、加若、Invoker	冰|雷|火|祈唤技能|祈唤技能|元素祈唤|急速冷却|幽灵漫步|强袭飓风|电磁脉冲|灵动迅捷|混沌陨石|阳炎冲击|熔炉精灵|寒冰之墙|超震声波
殁境神蚀者	Obsidian Destroyer	攻击类型：远程|定位：核心-高爆发-控制-|阵营：夜魇|其他简称：黑鸟	奥术天球|星体禁锢|精气光环|神智之蚀
暗影恶魔	Shadow Demon	攻击类型：远程|定位：辅助-控制-先手-高爆发-|阵营：夜魇|其他简称：毒狗	崩裂禁锢|灵魂猎手|暗影剧毒|释放暗影毒|邪恶净化
维萨吉	Visage	攻击类型：远程|定位：辅助-高爆发-耐久-控制-推进-|阵营：夜魇|其他简称：灰鸟，死灵飞龙	黄泉颤抖|灵魂超度|陵卫斗篷|召唤佣兽
寒冬飞龙	Winter Wyvern	攻击类型：远程|定位：辅助-控制-高爆发-|阵营：夜魇|其他简称：冰龙	严寒烧灼|碎裂冲击|极寒之拥|寒冬诅咒
