GMB	GambitEsports	未知
LYN	LYN	全球
ONE	ONE	全球
DW	DW	全球
KLG	KLG	全球
BabyGirl女子电竞俱乐部	BabyGirl女子电竞俱乐部	中国
NG电子竞技俱乐部	NG电子竞技俱乐部	中国
GAG	GAG女子战队	中国
GHG电子竞技俱乐部	GHG电子竞技俱乐部	中国
SCG	SCG	中国
魔鬼鱼女子俱乐部	魔鬼鱼女子俱乐部	中国
LLG女子职业俱乐部	LLG英雄联盟女子职业俱乐部	中国
NTG女子电竞俱乐部	NTG女子电竞俱乐部	中国
ＴＦ未来人类	ＴＦ未来人类	中国
KA女子电竞俱乐部	KA女子电竞俱乐部	中国
DNR女子电竞俱乐部	DNR女子电竞俱乐部	中国
RX女子俱乐部	RX女子俱乐部	中国
JDG京东女子战队	JDG京东女子战队	中国
Virtus.pro	Virtus.pro战队	2007-05-08
G2	G2	法国
ROX Tigers	ROX	韩国
JDM	JDM	中国
RT	RT	中国
TH	TH	中国
MSC	MSC	中国
TF	TF	中国
YG	YG	中国
GAM	GAM	越南
诗月	诗月	中国
止战之殇	止战之殇	中国
Ziyo	Ziyo	中国
QGHappy	QG电子竞技俱乐部	中国
GK	GANK GAMING	中国
JC	JC电子竞技俱乐部	中国
AG超玩会	AG超玩会	未知
Team Max	Team Max	未知
Cavalry	Cavalry Gaming	未知
Super Valiant	Super Valiant电子竞技俱乐部	中国
PENTA Sports	PENTA Sports	德国
梦工场	梦工场电子竞技俱乐部	中国
FlipSid3 Tactics	FlipSid3 Tactics	欧盟
Bheart.Z	BraveHeart.Zombie	未知
Team Monsters	Team Monsters	未知
Team sYa	Team sYa	2014-09-26
Team Empire	帝国战队	俄罗斯
GD	GD	中国
SAT	SAT	中国
NON	NON	中国
DAN	DAN	中国
InG	InG	中国
LD	LD	中国
OMD	OMD	中国
ME	ME	中国
RYL	SHR	中国
SNG	SNG	中国
DS	DS	中国
YM	YM	中国
RNG	RNG	中国
IM	IM	中国
Snake	Snake	中国
LGD	LGD	中国
IG	IG	中国
EDG	EDG	中国
EPG	Elements Pro Gaming	未知
WE	WE	中国
VG	VG	中国
Newbee	新兵电子竞技俱乐部	中国
JDG	JDG	中国
Rush.B	Rush.B	未知
Newbee.Boss	Newbee.Boss	2017-01-10
OMG	OMG	中国
TongFu	同福电子竞技俱乐部	中国
MVP.Miracle	MVP.Miracle	未知
AG	AG电子竞技俱乐部	中国
命刃	命刃	中国
战争	战争	中国
爱尚	爱尚	中国
Class302	Class302	中国
汉宫	汉宫Clan电子竞技俱乐部	中国
三年二班	三年二班	中国
L337	L337	中国
PE	PE	中国
内蒙铁骑	内蒙铁骑	中国
LA	LA	中国
天王	天王	中国
MoK.T	MoK.T战队	中国
NP	NP战队	中国
VG	VG战队	中国
MOK.HD	Mok.HD战队	中国
EP.NvA	EP战队	中国
Miracle	奇迹战队	中国
Ballistix	Ballistix	2016-06-01
WG	WarriorsGaming.Unity	未知
Ad Finem	Team AD FINEM	未知
WF	White Fries Gaming	未知
Team Faceless	假面战队	全球
Team NP	Team NP	未知
EHOME	EHOME电子竞技俱乐部	中国
CDEC	中国dota精英联盟	中国
Astral Authority	Astral Authority	2015-04-01
Dignitas	Team Dignitas全球电竞俱乐部	英国
CLG	CLG	加拿大
ANX	ANX	俄罗斯
FW	FW	中国
C9	C9	美国
AHQ	AHQ	中国
H2K	H2K	英国
INTZ	INTZ	巴西
TSM	TSM	美国
SSG	SSG	韩国
SPY	SPY	丹麦
SKTelecom T1	SKTelecom T1	韩国
Sc洪兴	Sc洪兴	未知
百万星光	百万星光	未知
LK	Lion King	未知
sViper	super viper	未知
AS仙阁	Asgard 仙阁	未知
WeFun	WeFun俱乐部	中国
MU	MU电子竞技俱乐部	中国
XQ	XQ俱乐部	未知
游久俱乐部	游久俱乐部	未知
TGF俱乐部	TGF俱乐部	中国
天道酬勤	天道酬勤电子竞技俱乐部	中国
AE	AE电子竞技俱乐部	中国
白鲨	白鲨电子竞技俱乐部	中国
SG丶翻车组	SG丶翻车组	未知
ZS丶Mx1	ZS丶Mx1	中国
MDS	MDS	未知
超玩会战队	超玩会战队	未知
仙阁天律	仙阁天律	未知
TKF	TKF	中国
GT	GT	中国
TCS	TCS	中国
RVG	RVG	中国
NBY	NBY	中国
Avalon	Avalon	未知
2144	2144	中国
WAY	we are young	中国
BHeart	无畏之心	中国
iG.V	iG.Vitality	2015-12-07
NewBee.Y	Newbee.Young	未知
FTD.C	FTD Club C	未知
FTD.A	FTD club a	未知
Wings	the wings gaming	未知
EHOME.K	EHOME.K	未知
TRG	雷神电竞俱乐部	中国
DuoBao	多宝电子竞技俱乐部	中国
VG.J	TEAM VG.J	2016-09-18
EHOME.X	EHOME.X	未知
LGD.F	LGD.FOREVER YOUNG	未知
CDEC.A	CDEC.A	中国
CDEC.Y	CDEC.Y	中国
